"date","geography","geography code","Rural Urban","Variable: All usual residents; measures: Value","Variable: Males; measures: Value","Variable: Females; measures: Value","Variable: Lives in a household; measures: Value","Variable: Lives in a communal establishment; measures: Value","Variable: Schoolchild or full-time student aged 4 and over at their non term-time address; measures: Value","Variable: Area (Hectares); measures: Value","Variable: Density (number of persons per hectare); measures: Value"
"2011","AL1","AL1","Total",36180,17993,18187,35902,278,616,1055.02,34.3
"2011","AL10","AL10","Total",35900,18327,17573,32907,2993,367,2023.54,17.7
"2011","AL2","AL2","Total",23604,11596,12008,23337,267,351,3734.88,6.3
"2011","AL3","AL3","Total",28462,13830,14632,28061,401,544,6803.77,4.2
"2011","AL4","AL4","Total",27268,13388,13880,27102,166,601,5299.97,5.1
"2011","AL5","AL5","Total",30240,14773,15467,29707,533,952,2310.24,13.1
"2011","AL6","AL6","Total",11222,5495,5727,11104,118,317,3311.32,3.4
"2011","AL7","AL7","Total",33890,16502,17388,33674,216,355,1063.16,31.9
"2011","AL8","AL8","Total",13252,6245,7007,13185,67,237,864.67,15.3
"2011","AL9","AL9","Total",10409,4952,5457,10074,335,234,4578.38,2.3
"2011","B1","B1","Total",7989,4505,3484,7088,901,68,101.44,78.8
"2011","B10","B10","Total",25908,13036,12872,25878,30,138,307,84.4
"2011","B11","B11","Total",44704,22555,22149,44583,121,312,628.65,71.1
"2011","B12","B12","Total",20755,10645,10110,20539,216,164,302.88,68.5
"2011","B13","B13","Total",36817,18501,18316,36323,494,418,915.32,40.2
"2011","B14","B14","Total",43413,21100,22313,43091,322,361,909.56,47.7
"2011","B15","B15","Total",18221,9119,9102,13517,4704,326,634.04,28.7
"2011","B16","B16","Total",23770,12451,11319,23580,190,175,390.1,60.9
"2011","B17","B17","Total",25563,12564,12999,25162,401,404,619.44,41.3
"2011","B18","B18","Total",16283,8387,7896,15306,977,98,322.54,50.5
"2011","B19","B19","Total",20068,10113,9955,19338,730,132,283.69,70.7
"2011","B2","B2","Total",616,353,263,615,1,3,23.3,26.4
"2011","B20","B20","Total",34089,17190,16899,33478,611,407,724.67,47
"2011","B21","B21","Total",30326,15283,15043,30289,37,236,455.96,66.5
"2011","B23","B23","Total",42870,20844,22026,42488,382,277,805.16,53.2
"2011","B24","B24","Total",28870,14153,14717,28427,443,214,841.61,34.3
"2011","B25","B25","Total",16005,7774,8231,15963,42,78,353.14,45.3
"2011","B26","B26","Total",32826,16217,16609,32767,59,220,692.43,47.4
"2011","B27","B27","Total",24834,12215,12619,24424,410,170,426.32,58.3
"2011","B28","B28","Total",30036,14725,15311,29961,75,382,584.41,51.4
"2011","B29","B29","Total",42024,20151,21873,40353,1671,421,797.35,52.7
"2011","B3","B3","Total",2574,1503,1071,2574,0,4,62.73,41
"2011","B30","B30","Total",29084,13943,15141,28456,628,303,773.46,37.6
"2011","B31","B31","Total",54302,26244,28058,54046,256,352,1353.94,40.1
"2011","B32","B32","Total",38518,18230,20288,38186,332,267,1587.85,24.3
"2011","B33","B33","Total",34513,16567,17946,34191,322,152,814.81,42.4
"2011","B34","B34","Total",19327,9130,10197,19183,144,96,466.75,41.4
"2011","B35","B35","Total",9971,4582,5389,9826,145,46,308.46,32.3
"2011","B36","B36","Total",34751,16710,18041,34633,118,231,764.69,45.4
"2011","B37","B37","Total",35728,17307,18421,35437,291,176,1184.14,30.2
"2011","B38","B38","Total",21354,10213,11141,20978,376,154,1126.5,19
"2011","B4","B4","Total",4683,2367,2316,1235,3448,92,149.54,31.3
"2011","B42","B42","Total",24367,11736,12631,23673,694,186,783.86,31.1
"2011","B43","B43","Total",28441,13818,14623,28428,13,301,883.63,32.2
"2011","B44","B44","Total",37091,17789,19302,36882,209,176,745.52,49.8
"2011","B45","B45","Total",30185,14724,15461,29957,228,311,2148.33,14.1
"2011","B46","B46","Total",12072,5912,6160,11916,156,139,5512.7,2.2
"2011","B47","B47","Total",9355,4553,4802,9317,38,126,1111.4,8.4
"2011","B48","B48","Total",5796,2821,2975,5626,170,97,2697.92,2.1
"2011","B49","B49","Total",10189,4971,5218,10030,159,194,8250.32,1.2
"2011","B5","B5","Total",11983,6146,5837,10574,1409,124,335.04,35.8
"2011","B50","B50","Total",5350,2608,2742,5273,77,69,1347.92,4
"2011","B6","B6","Total",19664,9925,9739,19572,92,134,423.83,46.4
"2011","B60","B60","Total",27951,13655,14296,27652,299,427,4828.96,5.8
"2011","B61","B61","Total",23470,11491,11979,22825,645,312,4478.31,5.2
"2011","B62","B62","Total",24401,11958,12443,24196,205,280,2292.1,10.6
"2011","B63","B63","Total",36431,17814,18617,36322,109,353,1178.43,30.9
"2011","B64","B64","Total",16528,8130,8398,16384,144,91,486.72,34
"2011","B65","B65","Total",23770,11621,12149,23678,92,89,654.16,36.3
"2011","B66","B66","Total",21334,10590,10744,21142,192,147,564.13,37.8
"2011","B67","B67","Total",30387,14866,15521,30195,192,235,525.57,57.8
"2011","B68","B68","Total",30588,14889,15699,30478,110,203,655.63,46.7
"2011","B69","B69","Total",28958,14372,14586,28703,255,162,952.63,30.4
"2011","B7","B7","Total",8546,4172,4374,8542,4,52,368.41,23.2
"2011","B70","B70","Total",27992,14263,13729,27716,276,184,1183.63,23.6
"2011","B71","B71","Total",30990,15147,15843,30697,293,194,965.61,32.1
"2011","B72","B72","Total",9569,4658,4911,9434,135,190,314.33,30.4
"2011","B73","B73","Total",22801,11105,11696,22609,192,457,651.92,35
"2011","B74","B74","Total",32470,15731,16739,32247,223,625,2585.68,12.6
"2011","B75","B75","Total",26687,12889,13798,26643,44,438,1879.71,14.2
"2011","B76","B76","Total",21651,10527,11124,21590,61,383,4147.01,5.2
"2011","B77","B77","Total",57313,28232,29081,57171,142,484,2350.7,24.4
"2011","B78","B78","Total",24374,12080,12294,24253,121,260,6584.07,3.7
"2011","B79","B79","Total",22126,10739,11387,21773,353,259,8975.08,2.5
"2011","B8","B8","Total",41929,21004,20925,41773,156,241,600.68,69.8
"2011","B80","B80","Total",7060,3444,3616,6983,77,81,3109.75,2.3
"2011","B9","B9","Total",24903,12260,12643,24718,185,114,487.61,51.1
"2011","B90","B90","Total",45359,21977,23382,45002,357,643,1784.96,25.4
"2011","B91","B91","Total",33166,16106,17060,32896,270,853,1602.27,20.7
"2011","B92","B92","Total",37245,18114,19131,36878,367,467,4140.95,9
"2011","B93","B93","Total",19706,9569,10137,19531,175,610,3078.44,6.4
"2011","B94","B94","Total",7380,3682,3698,7377,3,189,6419.89,1.1
"2011","B95","B95","Total",5663,2725,2938,5616,47,111,5282.45,1.1
"2011","B96","B96","Total",5073,2475,2598,5073,0,89,4166.98,1.2
"2011","B97","B97","Total",33494,17037,16457,32138,1356,395,5492.53,6.1
"2011","B98","B98","Total",50058,25022,25036,49951,107,410,2893.62,17.3
"2011","BA1","BA1","Total",40723,19951,20772,39750,973,787,5194.21,7.8
"2011","BA10","BA10","Total",3739,1820,1919,3238,501,143,4235.23,0.9
"2011","BA11","BA11","Total",32454,15820,16634,32025,429,455,12559.33,2.6
"2011","BA12","BA12","Total",28508,13799,14709,27933,575,660,35623.93,0.8
"2011","BA13","BA13","Total",20224,9806,10418,20079,145,285,7785.84,2.6
"2011","BA14","BA14","Total",48138,23548,24590,47689,449,599,8517.5,5.7
"2011","BA15","BA15","Total",13139,6211,6928,13080,59,286,3716.9,3.5
"2011","BA16","BA16","Total",13041,6376,6665,12109,932,166,3084.08,4.2
"2011","BA2","BA2","Total",73752,36099,37653,69251,4501,1275,15672.51,4.7
"2011","BA20","BA20","Total",10865,5376,5489,10568,297,125,553.07,19.6
"2011","BA21","BA21","Total",33619,16478,17141,33274,345,418,2249.27,14.9
"2011","BA22","BA22","Total",18166,9428,8738,16919,1247,406,18647.62,1
"2011","BA3","BA3","Total",34710,17175,17535,34061,649,484,14097.77,2.5
"2011","BA4","BA4","Total",17775,8888,8887,17379,396,298,16139.42,1.1
"2011","BA5","BA5","Total",17534,8291,9243,17015,519,365,11702.07,1.5
"2011","BA6","BA6","Total",12870,6246,6624,12465,405,245,9259.78,1.4
"2011","BA7","BA7","Total",3514,1653,1861,3396,118,54,1682.57,2.1
"2011","BA8","BA8","Total",4153,2047,2106,4117,36,76,4127.1,1
"2011","BA9","BA9","Total",7242,3506,3736,7128,114,164,7406.62,1
"2011","BB1","BB1","Total",66545,33266,33279,65879,666,659,4986.4,13.3
"2011","BB10","BB10","Total",37432,18490,18942,37156,276,380,7031.56,5.3
"2011","BB11","BB11","Total",22221,10852,11369,21846,375,228,2864.62,7.8
"2011","BB12","BB12","Total",34613,17005,17608,34320,293,396,5713.26,6.1
"2011","BB18","BB18","Total",17179,8486,8693,17095,84,172,4409.06,3.9
"2011","BB2","BB2","Total",59924,29891,30033,59067,857,678,4954.91,12.1
"2011","BB3","BB3","Total",34503,17062,17441,34229,274,295,4226.86,8.2
"2011","BB4","BB4","Total",41401,20306,21095,40866,535,547,7553.58,5.5
"2011","BB5","BB5","Total",61102,30208,30894,60506,596,498,4397.65,13.9
"2011","BB6","BB6","Total",14659,7265,7394,14541,118,201,2310.08,6.3
"2011","BB7","BB7","Total",31699,15595,16104,30856,843,559,41804.74,0.8
"2011","BB8","BB8","Total",23041,11283,11758,22849,192,208,6003.73,3.8
"2011","BB9","BB9","Total",44598,21935,22663,44270,328,455,3046.84,14.6
"2011","BD1","BD1","Total",3836,2252,1584,3832,4,20,107.95,35.5
"2011","BD10","BD10","Total",25882,12605,13277,25635,247,247,964.51,26.8
"2011","BD11","BD11","Total",11355,5518,5837,11242,113,96,1017.31,11.2
"2011","BD12","BD12","Total",16685,8129,8556,16642,43,118,1064.25,15.7
"2011","BD13","BD13","Total",24979,12157,12822,24840,139,245,3834.7,6.5
"2011","BD14","BD14","Total",8871,3966,4905,8291,580,102,401.56,22.1
"2011","BD15","BD15","Total",15316,7374,7942,15224,92,139,850.53,18
"2011","BD16","BD16","Total",25803,12704,13099,25666,137,444,3244.57,8
"2011","BD17","BD17","Total",17901,8743,9158,17815,86,213,1640.83,10.9
"2011","BD18","BD18","Total",27258,13334,13924,26990,268,271,844.16,32.3
"2011","BD19","BD19","Total",22019,10862,11157,21833,186,166,1418.9,15.5
"2011","BD2","BD2","Total",28566,13881,14685,28456,110,220,565.47,50.5
"2011","BD20","BD20","Total",35315,17020,18295,34478,837,489,9917.55,3.6
"2011","BD21","BD21","Total",27133,13537,13596,27068,65,133,1126.65,24.1
"2011","BD22","BD22","Total",29849,14503,15346,29700,149,333,8535.62,3.5
"2011","BD23","BD23","Total",29329,14135,15194,28934,395,557,74476.97,0.4
"2011","BD24","BD24","Total",5131,2500,2631,4875,256,116,14639.42,0.4
"2011","BD3","BD3","Total",34021,17110,16911,33739,282,156,530.27,64.2
"2011","BD4","BD4","Total",31218,15206,16012,30878,340,132,1991.11,15.7
"2011","BD5","BD5","Total",31641,16085,15556,30927,714,202,541.25,58.5
"2011","BD6","BD6","Total",30072,14410,15662,29894,178,176,656.06,45.8
"2011","BD7","BD7","Total",35345,18008,17337,33323,2022,327,655.45,53.9
"2011","BD8","BD8","Total",31502,15904,15598,31082,420,170,543.09,58
"2011","BD9","BD9","Total",29309,14566,14743,28883,426,228,672.95,43.6
"2011","BH1","BH1","Total",19304,10375,8929,18690,614,132,307.87,62.7
"2011","BH10","BH10","Total",20062,9753,10309,19935,127,177,632.6,31.7
"2011","BH11","BH11","Total",19910,9668,10242,19881,29,120,706.03,28.2
"2011","BH12","BH12","Total",35271,17389,17882,34794,477,287,951.74,37.1
"2011","BH13","BH13","Total",8321,4045,4276,7939,382,159,506.68,16.4
"2011","BH14","BH14","Total",23432,11535,11897,23102,330,312,685.89,34.2
"2011","BH15","BH15","Total",33052,16095,16957,32323,729,303,1023.88,32.3
"2011","BH16","BH16","Total",15835,7687,8148,15785,50,212,4140.16,3.8
"2011","BH17","BH17","Total",22983,11150,11833,22911,72,213,867.51,26.5
"2011","BH18","BH18","Total",11128,5329,5799,11031,97,246,658.87,16.9
"2011","BH19","BH19","Total",11517,5571,5946,11290,227,200,5177.15,2.2
"2011","BH2","BH2","Total",8345,4393,3952,8032,313,63,183.87,45.4
"2011","BH20","BH20","Total",19954,9892,10062,19577,377,319,25836.85,0.8
"2011","BH21","BH21","Total",40571,19606,20965,39819,752,734,22701.9,1.8
"2011","BH22","BH22","Total",26791,12719,14072,26383,408,263,2402.38,11.2
"2011","BH23","BH23","Total",52818,25308,27510,52265,553,549,8409.2,6.3
"2011","BH24","BH24","Total",23595,11339,12256,23094,501,359,15337.73,1.5
"2011","BH25","BH25","Total",25717,11937,13780,25052,665,251,2084.83,12.3
"2011","BH3","BH3","Total",5740,2892,2848,5597,143,108,211.43,27.1
"2011","BH31","BH31","Total",13360,6481,6879,13341,19,146,1327.2,10.1
"2011","BH4","BH4","Total",9382,4626,4756,8969,413,60,226.11,41.5
"2011","BH5","BH5","Total",11246,5803,5443,10719,527,85,182.8,61.5
"2011","BH6","BH6","Total",22199,10638,11561,21586,613,238,653.5,34
"2011","BH7","BH7","Total",11820,5839,5981,11761,59,168,391.47,30.2
"2011","BH8","BH8","Total",28015,13941,14074,26633,1382,318,742.66,37.7
"2011","BH9","BH9","Total",31619,15529,16090,31477,142,364,594.14,53.2
"2011","BL0","BL0","Total",17753,8616,9137,17681,72,330,2680.27,6.6
"2011","BL1","BL1","Total",63799,31851,31948,63526,273,727,2818.28,22.6
"2011","BL2","BL2","Total",45533,22014,23519,45041,492,437,2163.04,21.1
"2011","BL3","BL3","Total",64278,32162,32116,63606,672,499,1698.66,37.8
"2011","BL4","BL4","Total",33450,16311,17139,33249,201,174,1033.58,32.4
"2011","BL5","BL5","Total",27040,13325,13715,27007,33,337,2663.11,10.2
"2011","BL6","BL6","Total",29428,14446,14982,29176,252,385,4161.58,7.1
"2011","BL7","BL7","Total",14959,7336,7623,14954,5,262,5977.47,2.5
"2011","BL8","BL8","Total",35797,17554,18243,35064,733,580,2629.85,13.6
"2011","BL9","BL9","Total",48222,23825,24397,47727,495,527,4631.79,10.4
"2011","BN1","BN1","Total",84775,42558,42217,80233,4542,986,4434.81,19.1
"2011","BN10","BN10","Total",18579,9027,9552,18408,171,94,865.11,21.5
"2011","BN11","BN11","Total",33278,16019,17259,31771,1507,306,559.37,59.5
"2011","BN12","BN12","Total",20127,9421,10706,20008,119,194,888.82,22.6
"2011","BN13","BN13","Total",27536,13313,14223,27347,189,282,2351.12,11.7
"2011","BN14","BN14","Total",30736,14886,15850,30577,159,369,2806.13,11
"2011","BN15","BN15","Total",27371,13210,14161,26907,464,218,2448.62,11.2
"2011","BN16","BN16","Total",28334,13100,15234,27941,393,269,2532.1,11.2
"2011","BN17","BN17","Total",28292,13724,14568,27843,449,221,1635.54,17.3
"2011","BN18","BN18","Total",13468,6680,6788,12776,692,187,10619.41,1.3
"2011","BN2","BN2","Total",92743,46299,46444,91440,1303,749,3278.64,28.3
"2011","BN20","BN20","Total",20951,9739,11212,19994,957,273,3287.09,6.4
"2011","BN21","BN21","Total",25775,12470,13305,24532,1243,278,621.81,41.5
"2011","BN22","BN22","Total",32246,15425,16821,32024,222,225,1006.28,32
"2011","BN23","BN23","Total",28302,13653,14649,28253,49,232,716.83,39.5
"2011","BN24","BN24","Total",9291,4448,4843,9255,36,87,3537.35,2.6
"2011","BN25","BN25","Total",23571,11266,12305,23107,464,222,1726.53,13.7
"2011","BN26","BN26","Total",11426,5370,6056,11205,221,120,8698.33,1.3
"2011","BN27","BN27","Total",26842,12780,14062,26118,724,312,9145.09,2.9
"2011","BN3","BN3","Total",79513,39343,40170,78152,1361,883,1582.72,50.2
"2011","BN41","BN41","Total",20915,10113,10802,20780,135,169,844.38,24.8
"2011","BN42","BN42","Total",9991,4827,5164,9920,71,86,701.77,14.2
"2011","BN43","BN43","Total",22492,10834,11658,22269,223,237,984.36,22.8
"2011","BN44","BN44","Total",10125,4782,5343,9972,153,192,4913.51,2.1
"2011","BN45","BN45","Total",669,343,326,669,0,8,2247.3,0.3
"2011","BN5","BN5","Total",7106,3338,3768,6974,132,126,4814.61,1.5
"2011","BN6","BN6","Total",17400,8341,9059,17165,235,320,6273.87,2.8
"2011","BN7","BN7","Total",21190,10349,10841,20654,536,456,6905.58,3.1
"2011","BN8","BN8","Total",16310,7979,8331,16058,252,384,17768.8,0.9
"2011","BN9","BN9","Total",13477,6709,6768,13408,69,104,1946.96,6.9
"2011","BR1","BR1","Total",56331,26597,29734,55531,800,767,1313.42,42.9
"2011","BR2","BR2","Total",44840,21661,23179,44754,86,744,2673.29,16.8
"2011","BR3","BR3","Total",47324,22815,24509,46992,332,808,1308.56,36.2
"2011","BR4","BR4","Total",18986,9142,9844,18828,158,399,578.88,32.8
"2011","BR5","BR5","Total",45712,21634,24078,45652,60,494,2112.96,21.6
"2011","BR6","BR6","Total",46828,22593,24235,46708,120,800,3679.87,12.7
"2011","BR7","BR7","Total",17300,8306,8994,16758,542,375,1109.09,15.6
"2011","BR8","BR8","Total",21972,10617,11355,21969,3,237,1617.39,13.6
"2011","BS1","BS1","Total",11991,6504,5487,10380,1611,118,295.38,40.6
"2011","BS10","BS10","Total",27605,13207,14398,27321,284,176,1265.22,21.8
"2011","BS11","BS11","Total",17354,8403,8951,17236,118,99,1844.41,9.4
"2011","BS13","BS13","Total",29585,14069,15516,29448,137,111,856.59,34.5
"2011","BS14","BS14","Total",28155,13661,14494,27867,288,157,1068.62,26.3
"2011","BS15","BS15","Total",47327,23189,24138,46813,514,279,1076.59,44
"2011","BS16","BS16","Total",75908,37529,38379,72891,3017,820,3664.88,20.7
"2011","BS2","BS2","Total",15599,8253,7346,15283,316,105,244.71,63.7
"2011","BS20","BS20","Total",30003,14789,15214,29841,162,399,3687.53,8.1
"2011","BS21","BS21","Total",23283,11215,12068,22671,612,312,3946.97,5.9
"2011","BS22","BS22","Total",37442,18175,19267,37326,116,387,2434.19,15.4
"2011","BS23","BS23","Total",33996,16594,17402,32356,1640,249,1086.76,31.3
"2011","BS24","BS24","Total",18841,9062,9779,18734,107,182,4305.35,4.4
"2011","BS25","BS25","Total",6232,2995,3237,5904,328,128,2911.12,2.1
"2011","BS26","BS26","Total",5127,2528,2599,5066,61,124,5388.51,1
"2011","BS27","BS27","Total",7081,3375,3706,6969,112,140,4590.87,1.5
"2011","BS28","BS28","Total",3318,1633,1685,3318,0,88,4165.37,0.8
"2011","BS29","BS29","Total",2919,1410,1509,2919,0,37,1726.93,1.7
"2011","BS3","BS3","Total",36761,18338,18423,36477,284,232,708.06,51.9
"2011","BS30","BS30","Total",30360,14947,15413,30123,237,318,4395.2,6.9
"2011","BS31","BS31","Total",20000,9616,10384,19830,170,288,2458.3,8.1
"2011","BS32","BS32","Total",24758,12396,12362,24652,106,303,3534.33,7
"2011","BS34","BS34","Total",29790,14958,14832,29673,117,240,1242.53,24
"2011","BS35","BS35","Total",21640,10723,10917,21461,179,379,8638.79,2.5
"2011","BS36","BS36","Total",15443,7603,7840,15305,138,207,2307.93,6.7
"2011","BS37","BS37","Total",38061,18770,19291,37718,343,389,8463.49,4.5
"2011","BS39","BS39","Total",15463,7598,7865,15220,243,245,7505,2.1
"2011","BS4","BS4","Total",47959,23608,24351,47665,294,332,1208.44,39.7
"2011","BS40","BS40","Total",12786,6241,6545,12770,16,311,14538.28,0.9
"2011","BS41","BS41","Total",6083,2987,3096,6053,30,121,1697.28,3.6
"2011","BS48","BS48","Total",23408,11353,12055,23268,140,511,6322.78,3.7
"2011","BS49","BS49","Total",11951,5764,6187,11806,145,212,3480.71,3.4
"2011","BS5","BS5","Total",52343,26311,26032,52029,314,294,935.01,56
"2011","BS6","BS6","Total",33681,17404,16277,33151,530,571,380.15,88.6
"2011","BS7","BS7","Total",40933,20795,20138,40379,554,476,827.48,49.5
"2011","BS8","BS8","Total",26102,13596,12506,24702,1400,383,1460.96,17.9
"2011","BS9","BS9","Total",30953,14742,16211,28428,2525,694,1179.81,26.2
"2011","CA1","CA1","Total",24260,11872,12388,23904,356,207,926.91,26.2
"2011","CA10","CA10","Total",13623,6810,6813,13492,131,255,77267.1,0.2
"2011","CA11","CA11","Total",22359,10994,11365,21776,583,348,43711.19,0.5
"2011","CA12","CA12","Total",8026,3943,4083,7520,506,126,28608.29,0.3
"2011","CA13","CA13","Total",15006,7371,7635,14849,157,311,25242.44,0.6
"2011","CA14","CA14","Total",35799,17592,18207,35414,385,329,11104.27,3.2
"2011","CA15","CA15","Total",16218,7992,8226,16063,155,157,6791.38,2.4
"2011","CA16","CA16","Total",6175,3054,3121,6054,121,116,28510.65,0.2
"2011","CA17","CA17","Total",4873,2421,2452,4819,54,79,32419.63,0.2
"2011","CA18","CA18","Total",328,167,161,318,10,8,2935.47,0.1
"2011","CA19","CA19","Total",1069,554,515,1049,20,20,12548,0.1
"2011","CA2","CA2","Total",39435,19176,20259,38986,449,252,2563.65,15.4
"2011","CA20","CA20","Total",3355,1708,1647,3297,58,50,11383.91,0.3
"2011","CA21","CA21","Total",1017,526,491,1016,1,26,1095.08,0.9
"2011","CA22","CA22","Total",8887,4380,4507,8849,38,79,3840.21,2.3
"2011","CA23","CA23","Total",1424,738,686,1417,7,23,9548.22,0.1
"2011","CA24","CA24","Total",1266,664,602,1266,0,20,384.32,3.3
"2011","CA25","CA25","Total",6183,3091,3092,6122,61,52,1120.27,5.5
"2011","CA26","CA26","Total",3868,1903,1965,3867,1,32,2980.78,1.3
"2011","CA27","CA27","Total",1644,854,790,1561,83,59,741,2.2
"2011","CA28","CA28","Total",28592,14242,14350,28255,337,304,3197.91,8.9
"2011","CA3","CA3","Total",14015,6753,7262,13824,191,199,1094.58,12.8
"2011","CA4","CA4","Total",9679,4704,4975,9578,101,203,19210.3,0.5
"2011","CA5","CA5","Total",7114,3520,3594,7005,109,122,18345.98,0.4
"2011","CA6","CA6","Total",9094,4579,4515,8978,116,120,44826.26,0.2
"2011","CA7","CA7","Total",22533,11023,11510,22247,286,266,53216.97,0.4
"2011","CA8","CA8","Total",10314,5102,5212,10214,100,165,52759.61,0.2
"2011","CA9","CA9","Total",2088,1013,1075,2060,28,47,14948.78,0.1
"2011","CB1","CB1","Total",49238,24696,24542,47943,1295,772,1878.16,26.2
"2011","CB10","CB10","Total",13497,6740,6757,13244,253,366,14502.33,0.9
"2011","CB11","CB11","Total",18047,8864,9183,17828,219,426,12673.33,1.4
"2011","CB2","CB2","Total",18538,9777,8761,9514,9024,407,1098.76,16.9
"2011","CB21","CB21","Total",15626,7641,7985,15449,177,360,16855.2,0.9
"2011","CB22","CB22","Total",24025,11838,12187,23970,55,505,9651.14,2.5
"2011","CB23","CB23","Total",30885,15275,15610,30859,26,590,16874.29,1.8
"2011","CB24","CB24","Total",33040,16339,16701,32769,271,606,13120.32,2.5
"2011","CB25","CB25","Total",18264,9175,9089,17559,705,285,12940.19,1.4
"2011","CB3","CB3","Total",16270,8168,8102,10323,5947,367,1879.75,8.7
"2011","CB4","CB4","Total",41898,21234,20664,41112,786,571,1000.88,41.9
"2011","CB5","CB5","Total",11036,5661,5375,11010,26,124,1023.73,10.8
"2011","CB6","CB6","Total",38375,18996,19379,38126,249,423,25686.96,1.5
"2011","CB7","CB7","Total",26616,13239,13377,26320,296,332,21542.27,1.2
"2011","CB8","CB8","Total",33241,17088,16153,31869,1372,427,26995.54,1.2
"2011","CB9","CB9","Total",32871,16315,16556,32666,205,300,8913.48,3.7
"2011","CH1","CH1","Total",30560,14777,15783,29922,638,303,4919.33,6.2
"2011","CH2","CH2","Total",34321,16664,17657,33552,769,545,4728.31,7.3
"2011","CH3","CH3","Total",32010,15574,16436,31887,123,626,17008.3,1.9
"2011","CH4","CH4","Total",32297,15848,16449,32245,52,419,6458.67,5
"2011","CH41","CH41","Total",18667,9064,9603,18529,138,93,756.09,24.7
"2011","CH42","CH42","Total",31056,14934,16122,30684,372,225,585.83,53
"2011","CH43","CH43","Total",38916,18787,20129,38240,676,377,1186.5,32.8
"2011","CH44","CH44","Total",29914,14652,15262,29618,296,197,522.96,57.2
"2011","CH45","CH45","Total",30855,14938,15917,30528,327,357,699.7,44.1
"2011","CH46","CH46","Total",25480,12243,13237,25386,94,183,1063.15,24
"2011","CH47","CH47","Total",10909,5196,5713,10642,267,224,820.76,13.3
"2011","CH48","CH48","Total",15206,7237,7969,15033,173,352,1202.53,12.6
"2011","CH49","CH49","Total",28777,13569,15208,28474,303,380,997.27,28.9
"2011","CH5","CH5","Total",42525,21088,21437,42382,143,399,6191.55,6.9
"2011","CH6","CH6","Total",17118,8425,8693,16968,150,168,2850.92,6
"2011","CH60","CH60","Total",13084,6260,6824,13025,59,345,1188.59,11
"2011","CH61","CH61","Total",17590,8362,9228,17494,96,309,1792.14,9.8
"2011","CH62","CH62","Total",28732,13913,14819,28519,213,244,1538.61,18.7
"2011","CH63","CH63","Total",30597,14692,15905,30212,385,416,3350.81,9.1
"2011","CH64","CH64","Total",18921,9094,9827,18778,143,339,4442.68,4.3
"2011","CH65","CH65","Total",26371,12885,13486,26129,242,163,2925.12,9
"2011","CH66","CH66","Total",35092,17104,17988,34893,199,386,1912.02,18.4
"2011","CH7","CH7","Total",50066,24554,25512,49689,377,692,20385.49,2.5
"2011","CH8","CH8","Total",20679,10290,10389,20553,126,208,11023.24,1.9
"2011","CM0","CM0","Total",16003,7979,8024,15884,119,170,12609.96,1.3
"2011","CM1","CM1","Total",62862,30813,32049,61704,1158,909,11129.23,5.6
"2011","CM11","CM11","Total",19001,9312,9689,18987,14,311,2610.52,7.3
"2011","CM12","CM12","Total",19822,9672,10150,19748,74,323,1990.97,10
"2011","CM13","CM13","Total",24494,11814,12680,24171,323,465,5507.1,4.4
"2011","CM14","CM14","Total",19746,9575,10171,19466,280,294,3508.84,5.6
"2011","CM15","CM15","Total",23406,11374,12032,23213,193,452,3949.78,5.9
"2011","CM16","CM16","Total",22096,10639,11457,21836,260,317,5971.31,3.7
"2011","CM17","CM17","Total",21296,10253,11043,21247,49,185,3594.75,5.9
"2011","CM18","CM18","Total",24425,11746,12679,24262,163,222,564.86,43.2
"2011","CM19","CM19","Total",18811,9252,9559,18774,37,182,1261,14.9
"2011","CM2","CM2","Total",58252,28777,29475,57726,526,854,4989.89,11.7
"2011","CM20","CM20","Total",21400,10378,11022,21250,150,159,1922.5,11.1
"2011","CM21","CM21","Total",10838,5349,5489,10706,132,176,2714.51,4
"2011","CM22","CM22","Total",13232,6534,6698,13171,61,256,10030.44,1.3
"2011","CM23","CM23","Total",40615,19875,20740,40070,545,853,5003.31,8.1
"2011","CM24","CM24","Total",6669,3346,3323,6594,75,108,1647,4
"2011","CM3","CM3","Total",54108,26797,27311,53655,453,891,25994.81,2.1
"2011","CM4","CM4","Total",10181,4884,5297,10165,16,203,6306.23,1.6
"2011","CM5","CM5","Total",10581,5178,5403,10564,17,171,10524.13,1
"2011","CM6","CM6","Total",25184,12349,12835,24668,516,473,19231.95,1.3
"2011","CM7","CM7","Total",48743,23919,24824,48108,635,540,12535.9,3.9
"2011","CM77","CM77","Total",15395,7517,7878,15291,104,197,5286.76,2.9
"2011","CM8","CM8","Total",32807,16052,16755,32543,264,306,5689.14,5.8
"2011","CM9","CM9","Total",33525,16439,17086,33149,376,432,15020.64,2.2
"2011","CO1","CO1","Total",14988,7384,7604,14820,168,121,418.51,35.8
"2011","CO10","CO10","Total",46329,22626,23703,45781,548,650,29881.01,1.6
"2011","CO11","CO11","Total",12950,6283,6667,12869,81,173,6069.04,2.1
"2011","CO12","CO12","Total",22215,10834,11381,22046,169,172,4071.64,5.5
"2011","CO13","CO13","Total",12110,5628,6482,11948,162,171,1794.58,6.7
"2011","CO14","CO14","Total",6735,3018,3717,6538,197,58,698.89,9.6
"2011","CO15","CO15","Total",43054,20355,22699,42007,1047,273,1819.45,23.7
"2011","CO16","CO16","Total",24196,11661,12535,23991,205,184,10072.68,2.4
"2011","CO2","CO2","Total",35114,17943,17171,32916,2198,315,4773.74,7.4
"2011","CO3","CO3","Total",28117,13636,14481,27715,402,523,2332.84,12.1
"2011","CO4","CO4","Total",48002,23527,24475,45205,2797,579,4448.7,10.8
"2011","CO5","CO5","Total",28199,13706,14493,27978,221,351,12185.74,2.3
"2011","CO6","CO6","Total",28893,14108,14785,28452,441,566,18735.83,1.5
"2011","CO7","CO7","Total",32953,16238,16715,32509,444,518,15326.23,2.2
"2011","CO8","CO8","Total",2303,1138,1165,2303,0,75,3384.94,0.7
"2011","CO9","CO9","Total",25260,12445,12815,24983,277,315,16020.04,1.6
"2011","CR0","CR0","Total",154233,74943,79290,153241,992,1683,3365.61,45.8
"2011","CR2","CR2","Total",48467,23633,24834,47853,614,753,1781.56,27.2
"2011","CR3","CR3","Total",28539,13790,14749,27661,878,492,2713.58,10.5
"2011","CR4","CR4","Total",58802,28837,29965,58476,326,623,986.82,59.6
"2011","CR5","CR5","Total",28862,14045,14817,28717,145,503,2580.69,11.2
"2011","CR6","CR6","Total",9843,4740,5103,9777,66,182,2139.72,4.6
"2011","CR7","CR7","Total",44691,21459,23232,44418,273,601,455.6,98.1
"2011","CR8","CR8","Total",32545,15837,16708,31768,777,701,1256.54,25.9
"2011","CT1","CT1","Total",30755,14971,15784,28025,2730,463,1734.47,17.7
"2011","CT10","CT10","Total",24903,11787,13116,24189,714,346,1135.81,21.9
"2011","CT11","CT11","Total",29206,14226,14980,28759,447,265,615.44,47.5
"2011","CT12","CT12","Total",17826,8566,9260,17784,42,135,3842.38,4.6
"2011","CT13","CT13","Total",8901,4281,4620,8780,121,143,4285.71,2.1
"2011","CT14","CT14","Total",35056,16870,18186,34344,712,360,5354.63,6.5
"2011","CT15","CT15","Total",13238,6575,6663,12715,523,191,11041.19,1.2
"2011","CT16","CT16","Total",19623,9702,9921,19315,308,165,1556.03,12.6
"2011","CT17","CT17","Total",22086,11086,11000,21643,443,189,1258.27,17.6
"2011","CT18","CT18","Total",13909,6791,7118,13847,62,165,4291.91,3.2
"2011","CT19","CT19","Total",28867,14001,14866,28725,142,223,1056.44,27.3
"2011","CT2","CT2","Total",30718,14749,15969,26325,4393,496,3264.36,9.4
"2011","CT20","CT20","Total",22470,11691,10779,21662,808,182,560.23,40.1
"2011","CT21","CT21","Total",17147,8060,9087,16781,366,213,3854.83,4.4
"2011","CT3","CT3","Total",17284,8409,8875,17032,252,249,14285.18,1.2
"2011","CT4","CT4","Total",16633,8068,8565,16411,222,357,21536.26,0.8
"2011","CT5","CT5","Total",33068,15699,17369,32790,278,372,3857.76,8.6
"2011","CT6","CT6","Total",38563,18507,20056,37738,825,340,3106,12.4
"2011","CT7","CT7","Total",11459,5358,6101,11362,97,115,2740.1,4.2
"2011","CT8","CT8","Total",7338,3432,3906,7010,328,54,221.76,33.1
"2011","CT9","CT9","Total",43454,21186,22268,42651,803,341,1778.04,24.4
"2011","CV1","CV1","Total",31181,16978,14203,27185,3996,352,516.02,60.4
"2011","CV10","CV10","Total",49883,24466,25417,49683,200,384,5468.87,9.1
"2011","CV11","CV11","Total",39428,19566,19862,38825,603,568,2960.21,13.3
"2011","CV12","CV12","Total",31606,15442,16164,31428,178,255,2472.75,12.8
"2011","CV13","CV13","Total",10714,5342,5372,10505,209,213,11196.41,1
"2011","CV2","CV2","Total",63206,31071,32135,62876,330,555,1545.4,40.9
"2011","CV21","CV21","Total",35590,17973,17617,35327,263,397,1439.1,24.7
"2011","CV22","CV22","Total",35333,17284,18049,34285,1048,557,2867.77,12.3
"2011","CV23","CV23","Total",21836,11364,10472,20466,1370,364,24994.25,0.9
"2011","CV3","CV3","Total",63323,31228,32095,62850,473,782,2110.85,30
"2011","CV31","CV31","Total",31530,16199,15331,31160,370,343,1741.62,18.1
"2011","CV32","CV32","Total",32696,16193,16503,32046,650,486,2195.6,14.9
"2011","CV33","CV33","Total",6103,3000,3103,6087,16,105,7039.72,0.9
"2011","CV34","CV34","Total",31345,15553,15792,31118,227,435,2190.25,14.3
"2011","CV35","CV35","Total",24609,11946,12663,24284,325,596,24171.33,1
"2011","CV36","CV36","Total",9286,4457,4829,9235,51,188,10795.68,0.9
"2011","CV37","CV37","Total",40998,19845,21153,40385,613,758,22695.78,1.8
"2011","CV4","CV4","Total",33370,16506,16864,28098,5272,439,1878.41,17.8
"2011","CV47","CV47","Total",16967,8396,8571,16756,211,293,16737.84,1
"2011","CV5","CV5","Total",45968,22814,23154,45618,350,625,2343.92,19.6
"2011","CV6","CV6","Total",86522,42368,44154,86132,390,751,1960.97,44.1
"2011","CV7","CV7","Total",28078,13791,14287,27693,385,418,13333.3,2.1
"2011","CV8","CV8","Total",31031,15248,15783,30860,171,685,10989.81,2.8
"2011","CV9","CV9","Total",21204,10453,10751,21086,118,238,10719.72,2
"2011","CW1","CW1","Total",42379,20870,21509,41132,1247,395,4500.26,9.4
"2011","CW10","CW10","Total",14361,7099,7262,14256,105,164,3515.93,4.1
"2011","CW11","CW11","Total",22615,11082,11533,22466,149,417,8549.19,2.6
"2011","CW12","CW12","Total",29225,14400,14825,28884,341,404,8050.35,3.6
"2011","CW2","CW2","Total",41120,20510,20610,40950,170,397,4996.33,8.2
"2011","CW3","CW3","Total",9079,4421,4658,8955,124,166,6871.05,1.3
"2011","CW4","CW4","Total",9378,4589,4789,9338,40,235,3793.92,2.5
"2011","CW5","CW5","Total",29281,14273,15008,28758,523,451,18380.36,1.6
"2011","CW6","CW6","Total",12160,5922,6238,12029,131,324,12979.57,0.9
"2011","CW7","CW7","Total",31454,15250,16204,31193,261,312,5251.8,6
"2011","CW8","CW8","Total",35290,17259,18031,35095,195,565,8544,4.1
"2011","CW9","CW9","Total",33147,16499,16648,32825,322,461,8285.38,4
"2011","DA1","DA1","Total",52687,25931,26756,52580,107,536,1968.55,26.8
"2011","DA10","DA10","Total",6746,3348,3398,6738,8,45,385.83,17.5
"2011","DA11","DA11","Total",38059,18825,19234,37613,446,330,1033.9,36.8
"2011","DA12","DA12","Total",47392,23371,24021,47140,252,469,3715.86,12.8
"2011","DA13","DA13","Total",14449,7066,7383,14370,79,240,4787.55,3
"2011","DA14","DA14","Total",21183,9820,11363,21024,159,208,1052.73,20.1
"2011","DA15","DA15","Total",29427,14255,15172,29017,410,326,592.59,49.7
"2011","DA16","DA16","Total",35912,17340,18572,35849,63,393,607.36,59.1
"2011","DA17","DA17","Total",17104,8223,8881,17091,13,151,474.8,36
"2011","DA18","DA18","Total",4939,2397,2542,4925,14,68,278.86,17.7
"2011","DA2","DA2","Total",22994,11242,11752,22425,569,225,2371.47,9.7
"2011","DA3","DA3","Total",16748,8084,8664,16534,214,300,1841.77,9.1
"2011","DA4","DA4","Total",9062,4374,4688,9016,46,123,3890.18,2.3
"2011","DA5","DA5","Total",20824,10234,10590,20741,83,273,828.41,25.1
"2011","DA6","DA6","Total",9846,4803,5043,9816,30,122,264.11,37.3
"2011","DA7","DA7","Total",35540,17121,18419,35363,177,447,696.06,51.1
"2011","DA8","DA8","Total",34559,16637,17922,34419,140,326,864.36,40
"2011","DA9","DA9","Total",13089,6622,6467,12969,120,78,940.8,13.9
"2011","DE1","DE1","Total",13807,7572,6235,12263,1544,123,359.68,38.4
"2011","DE11","DE11","Total",43809,21789,22020,43609,200,349,3532.42,12.4
"2011","DE12","DE12","Total",20462,10202,10260,20265,197,226,9582.32,2.1
"2011","DE13","DE13","Total",40596,19674,20922,40301,295,599,16458.25,2.5
"2011","DE14","DE14","Total",28844,14564,14280,28633,211,224,1829.19,15.8
"2011","DE15","DE15","Total",24192,11812,12380,23779,413,245,3722.45,6.5
"2011","DE21","DE21","Total",57016,27844,29172,56705,311,452,3489.37,16.3
"2011","DE22","DE22","Total",46544,23113,23431,45482,1062,572,3159.55,14.7
"2011","DE23","DE23","Total",59900,29744,30156,59260,640,679,1196.62,50.1
"2011","DE24","DE24","Total",54523,26748,27775,54116,407,352,2056.85,26.5
"2011","DE3","DE3","Total",17008,8209,8799,16862,146,305,555.99,30.6
"2011","DE4","DE4","Total",33166,16359,16807,32841,325,560,19109.2,1.7
"2011","DE45","DE45","Total",8676,4087,4589,8398,278,195,13050.21,0.7
"2011","DE5","DE5","Total",22033,10830,11203,21798,235,185,3045.68,7.2
"2011","DE55","DE55","Total",51224,25285,25939,50759,465,385,9001.75,5.7
"2011","DE56","DE56","Total",40374,19838,20536,39917,457,604,10718.91,3.8
"2011","DE6","DE6","Total",25593,12828,12765,24656,937,491,40697.2,0.6
"2011","DE65","DE65","Total",23456,11611,11845,22534,922,348,11888.57,2
"2011","DE7","DE7","Total",49916,24497,25419,49299,617,354,6391.66,7.8
"2011","DE72","DE72","Total",20225,9808,10417,19998,227,285,5883.31,3.4
"2011","DE73","DE73","Total",19052,9337,9715,19009,43,330,7435.91,2.6
"2011","DE74","DE74","Total",11491,5762,5729,11363,128,160,4414.29,2.6
"2011","DE75","DE75","Total",18713,9233,9480,18595,118,131,1463.54,12.8
"2011","DH1","DH1","Total",49865,25044,24821,41984,7881,791,4676.48,10.7
"2011","DH2","DH2","Total",30427,14772,15655,30189,238,273,2640.64,11.5
"2011","DH3","DH3","Total",25904,12454,13450,25722,182,204,2077.73,12.5
"2011","DH4","DH4","Total",33471,16237,17234,33184,287,206,3450.82,9.7
"2011","DH5","DH5","Total",19534,9434,10100,19453,81,100,2684.55,7.3
"2011","DH6","DH6","Total",33392,16529,16863,33202,190,251,10047.92,3.3
"2011","DH7","DH7","Total",41375,20183,21192,41084,291,415,16386.89,2.5
"2011","DH8","DH8","Total",38551,18879,19672,38057,494,347,24933.88,1.5
"2011","DH9","DH9","Total",36692,17959,18733,36337,355,205,4756.79,7.7
"2011","DL1","DL1","Total",46371,22582,23789,45644,727,374,5039.26,9.2
"2011","DL10","DL10","Total",18424,9195,9229,17557,867,366,12816.05,1.4
"2011","DL11","DL11","Total",5308,2663,2645,5280,28,138,54289.04,0.1
"2011","DL12","DL12","Total",12407,6229,6178,11545,862,205,54074.27,0.2
"2011","DL13","DL13","Total",14158,7035,7123,14078,80,161,48735.41,0.3
"2011","DL14","DL14","Total",37072,17857,19215,36577,495,340,7378.12,5
"2011","DL15","DL15","Total",22497,11038,11459,22249,248,185,5651.06,4
"2011","DL16","DL16","Total",19816,9745,10071,19768,48,170,3048.18,6.5
"2011","DL17","DL17","Total",17672,8623,9049,17531,141,120,4324.32,4.1
"2011","DL2","DL2","Total",16980,8297,8683,16747,233,282,25883.06,0.7
"2011","DL3","DL3","Total",44712,21817,22895,44212,500,616,1488.87,30
"2011","DL4","DL4","Total",9976,4856,5120,9852,124,66,1062.65,9.4
"2011","DL5","DL5","Total",29340,14176,15164,29044,296,323,4198.16,7
"2011","DL6","DL6","Total",15515,7677,7838,15287,228,244,20404.38,0.8
"2011","DL7","DL7","Total",16218,8130,8088,15393,825,293,16300.35,1
"2011","DL8","DL8","Total",18650,9216,9434,18397,253,328,73576.35,0.3
"2011","DL9","DL9","Total",15859,9389,6470,12309,3550,195,2715.18,5.8
"2011","DN1","DN1","Total",8735,4741,3994,8503,232,70,279.27,31.3
"2011","DN10","DN10","Total",12086,5999,6087,11955,131,245,13787.1,0.9
"2011","DN11","DN11","Total",28352,13674,14678,27956,396,240,7398.7,3.8
"2011","DN12","DN12","Total",24119,11706,12413,23924,195,119,1665.11,14.5
"2011","DN14","DN14","Total",46242,22767,23475,45737,505,428,33283.22,1.4
"2011","DN15","DN15","Total",36603,18434,18169,36230,373,342,14244.18,2.6
"2011","DN16","DN16","Total",31667,15454,16213,31412,255,269,2848.99,11.1
"2011","DN17","DN17","Total",37188,18353,18835,36944,244,360,15391.61,2.4
"2011","DN18","DN18","Total",11717,5691,6026,11611,106,119,3203.49,3.7
"2011","DN19","DN19","Total",6282,3136,3146,6206,76,75,4365.04,1.4
"2011","DN2","DN2","Total",24551,11948,12603,24299,252,234,915.83,26.8
"2011","DN20","DN20","Total",19187,9399,9788,18887,300,245,12262.81,1.6
"2011","DN21","DN21","Total",37221,18206,19015,36585,636,414,34973.77,1.1
"2011","DN22","DN22","Total",36086,18371,17715,34220,1866,516,27295.3,1.3
"2011","DN3","DN3","Total",30069,14671,15398,29889,180,277,4073.06,7.4
"2011","DN31","DN31","Total",9619,4763,4856,9599,20,50,397.71,24.2
"2011","DN32","DN32","Total",30257,15324,14933,29871,386,198,825.59,36.6
"2011","DN33","DN33","Total",19538,9387,10151,19301,237,178,578.22,33.8
"2011","DN34","DN34","Total",19001,9165,9836,18676,325,157,513.23,37
"2011","DN35","DN35","Total",34561,16794,17767,34256,305,237,882.34,39.2
"2011","DN36","DN36","Total",19103,9344,9759,18865,238,289,9553.84,2
"2011","DN37","DN37","Total",21745,10618,11127,21420,325,280,12457.34,1.7
"2011","DN38","DN38","Total",3023,1467,1556,3008,15,53,5491.96,0.6
"2011","DN39","DN39","Total",2846,1389,1457,2846,0,33,6101.62,0.5
"2011","DN4","DN4","Total",53415,26254,27161,53010,405,625,2703.98,19.8
"2011","DN40","DN40","Total",12299,6033,6266,12211,88,83,5950.17,2.1
"2011","DN41","DN41","Total",6266,3067,3199,6222,44,112,5309.1,1.2
"2011","DN5","DN5","Total",40864,20058,20806,40047,817,461,10080.73,4.1
"2011","DN6","DN6","Total",31148,15288,15860,30881,267,180,10788.94,2.9
"2011","DN7","DN7","Total",24610,13038,11572,22385,2225,177,8904.4,2.8
"2011","DN8","DN8","Total",17295,8398,8897,17143,152,140,4700.29,3.7
"2011","DN9","DN9","Total",20018,9753,10265,19940,78,323,15653.05,1.3
"2011","DT1","DT1","Total",19060,9215,9845,18489,571,336,712.03,26.8
"2011","DT10","DT10","Total",11841,5826,6015,11747,94,233,11666.97,1
"2011","DT11","DT11","Total",30156,15305,14851,28039,2117,642,33115.47,0.9
"2011","DT2","DT2","Total",24826,12176,12650,24557,269,503,62406.24,0.4
"2011","DT3","DT3","Total",23138,11267,11871,22850,288,313,9260.73,2.5
"2011","DT4","DT4","Total",37293,18331,18962,36614,679,390,1211.69,30.8
"2011","DT5","DT5","Total",12844,6797,6047,11863,981,100,1208.72,10.6
"2011","DT6","DT6","Total",21559,10218,11341,21288,271,324,16593.02,1.3
"2011","DT7","DT7","Total",5696,2628,3068,5500,196,117,2904.12,2
"2011","DT8","DT8","Total",6000,2891,3109,5942,58,105,8927.24,0.7
"2011","DT9","DT9","Total",20790,9965,10825,19566,1224,457,19421.7,1.1
"2011","DY1","DY1","Total",32131,15861,16270,31681,450,220,900.73,35.7
"2011","DY10","DY10","Total",35814,17714,18100,35280,534,406,6608.7,5.4
"2011","DY11","DY11","Total",30077,14845,15232,29783,294,281,2948.85,10.2
"2011","DY12","DY12","Total",12305,6129,6176,12193,112,201,9556.33,1.3
"2011","DY13","DY13","Total",22209,10850,11359,22010,199,201,4402.13,5
"2011","DY14","DY14","Total",8529,4279,4250,8425,104,150,15391.73,0.6
"2011","DY2","DY2","Total",34461,16988,17473,34218,243,171,1000.52,34.4
"2011","DY3","DY3","Total",33730,16449,17281,33440,290,219,2621.02,12.9
"2011","DY4","DY4","Total",42846,21192,21654,42496,350,146,1013.31,42.3
"2011","DY5","DY5","Total",41898,20776,21122,41744,154,279,1279.41,32.7
"2011","DY6","DY6","Total",27489,13461,14028,27264,225,288,933.43,29.4
"2011","DY7","DY7","Total",8300,4011,4289,8142,158,175,7297.56,1.1
"2011","DY8","DY8","Total",50737,24963,25774,49887,850,629,1565.42,32.4
"2011","DY9","DY9","Total",30072,14761,15311,29683,389,406,4127.76,7.3
"2011","E1","E1","Total",70389,36783,33606,67520,2869,488,551.16,127.7
"2011","E10","E10","Total",43120,21750,21370,43010,110,235,571.08,75.5
"2011","E11","E11","Total",54689,27664,27025,54088,601,571,833.52,65.6
"2011","E12","E12","Total",42606,22387,20219,42388,218,390,567.98,75
"2011","E13","E13","Total",47169,24462,22707,47060,109,371,343.62,137.3
"2011","E14","E14","Total",82638,42838,39800,82449,189,459,705.27,117.2
"2011","E15","E15","Total",51650,26642,25008,51490,160,331,701.4,73.6
"2011","E16","E16","Total",45371,22746,22625,44620,751,400,876.76,51.7
"2011","E17","E17","Total",103129,51599,51530,102478,651,743,1437.24,71.8
"2011","E18","E18","Total",19864,9657,10207,19798,66,267,315.78,62.9
"2011","E1W","E1W","Total",12428,6758,5670,12361,67,68,106.19,117
"2011","E2","E2","Total",45811,23220,22591,45326,485,235,275.26,166.4
"2011","E3","E3","Total",52371,26264,26107,52202,169,311,490.54,106.8
"2011","E4","E4","Total",60357,29046,31311,59898,459,702,1842.55,32.8
"2011","E5","E5","Total",48492,23780,24712,48256,236,441,361.44,134.2
"2011","E6","E6","Total",78790,41017,37773,78575,215,632,1051.91,74.9
"2011","E7","E7","Total",54133,29083,25050,53553,580,460,350.34,154.5
"2011","E8","E8","Total",39260,19502,19758,39165,95,295,275.21,142.7
"2011","E9","E9","Total",37768,18422,19346,37446,322,348,453.99,83.2
"2011","EC1A","EC1A","Total",894,507,387,844,50,12,39.64,22.6
"2011","EC1M","EC1M","Total",2473,1326,1147,1777,696,12,24.87,99.4
"2011","EC1N","EC1N","Total",2650,1397,1253,2549,101,19,20.85,127.1
"2011","EC1R","EC1R","Total",4885,2564,2321,4676,209,44,46.13,105.9
"2011","EC1V","EC1V","Total",12765,6513,6252,11911,854,138,76.84,166.1
"2011","EC1Y","EC1Y","Total",3767,1966,1801,3455,312,21,32.66,115.3
"2011","EC2A","EC2A","Total",1229,735,494,1229,0,1,24.93,49.3
"2011","EC2Y","EC2Y","Total",3249,1727,1522,3165,84,47,31.18,104.2
"2011","EC3R","EC3R","Total",227,149,78,227,0,5,33.92,6.7
"2011","EC4A","EC4A","Total",151,90,61,151,0,0,7.86,19.2
"2011","EC4V","EC4V","Total",595,357,238,554,41,4,49.91,11.9
"2011","EC4Y","EC4Y","Total",320,196,124,320,0,5,23.96,13.4
"2011","EN1","EN1","Total",44997,21637,23360,44641,356,556,833.83,54
"2011","EN10","EN10","Total",17036,8260,8776,16912,124,218,1144.58,14.9
"2011","EN11","EN11","Total",21451,10515,10936,21356,95,193,1257.7,17.1
"2011","EN2","EN2","Total",29709,14393,15316,29367,342,439,2207.41,13.5
"2011","EN3","EN3","Total",57073,27216,29857,56846,227,572,1259.48,45.3
"2011","EN4","EN4","Total",25578,12458,13120,25240,338,486,1277.01,20
"2011","EN5","EN5","Total",38071,18205,19866,37517,554,695,2663.76,14.3
"2011","EN6","EN6","Total",29010,13778,15232,28788,222,521,4035.9,7.2
"2011","EN7","EN7","Total",22050,10687,11363,21987,63,238,2211.98,10
"2011","EN8","EN8","Total",35826,17178,18648,35726,100,319,923.03,38.8
"2011","EN9","EN9","Total",23633,11572,12061,23378,255,193,4635.84,5.1
"2011","EX1","EX1","Total",21521,10507,11014,20695,826,259,842.24,25.6
"2011","EX10","EX10","Total",17207,7964,9243,16725,482,352,8417.96,2
"2011","EX11","EX11","Total",7795,3733,4062,7730,65,146,3213.48,2.4
"2011","EX12","EX12","Total",9416,4390,5026,9221,195,100,3798.21,2.5
"2011","EX13","EX13","Total",11329,5463,5866,11181,148,141,11216.01,1
"2011","EX14","EX14","Total",20687,9952,10735,20526,161,270,21402.72,1
"2011","EX15","EX15","Total",21313,10471,10842,21105,208,297,19255.41,1.1
"2011","EX16","EX16","Total",32440,15878,16562,32005,435,437,38726.71,0.8
"2011","EX17","EX17","Total",19539,9597,9942,19330,209,287,31178.2,0.6
"2011","EX18","EX18","Total",3117,1531,1586,3091,26,64,12692.91,0.2
"2011","EX19","EX19","Total",3525,1740,1785,3501,24,50,9227.99,0.4
"2011","EX2","EX2","Total",40698,19669,21029,39847,851,438,4304.93,9.5
"2011","EX20","EX20","Total",19966,9850,10116,19652,314,275,47753.96,0.4
"2011","EX21","EX21","Total",4620,2279,2341,4467,153,71,18937.03,0.2
"2011","EX22","EX22","Total",10745,5300,5445,10539,206,131,33818.49,0.3
"2011","EX23","EX23","Total",15704,7629,8075,15379,325,240,18276.94,0.9
"2011","EX24","EX24","Total",3789,1799,1990,3748,41,85,5470.77,0.7
"2011","EX3","EX3","Total",4940,2267,2673,4927,13,97,1022.88,4.8
"2011","EX31","EX31","Total",25475,12531,12944,24727,748,380,26053.58,1
"2011","EX32","EX32","Total",23778,11498,12280,23483,295,284,13636.42,1.7
"2011","EX33","EX33","Total",10224,4930,5294,10101,123,173,5923.45,1.7
"2011","EX34","EX34","Total",17306,8421,8885,16828,478,174,8971.81,1.9
"2011","EX35","EX35","Total",1647,791,856,1450,197,21,6857.1,0.2
"2011","EX36","EX36","Total",8477,4103,4374,8337,140,127,24310.62,0.3
"2011","EX37","EX37","Total",3362,1655,1707,3334,28,62,11845.64,0.3
"2011","EX38","EX38","Total",8132,3920,4212,8007,125,89,10024.78,0.8
"2011","EX39","EX39","Total",37163,18070,19093,36590,573,426,26175.59,1.4
"2011","EX4","EX4","Total",54711,26744,27967,50376,4335,607,4910.49,11.1
"2011","EX5","EX5","Total",18568,8971,9597,18421,147,356,21606,0.9
"2011","EX6","EX6","Total",13673,6665,7008,13562,111,257,21890.44,0.6
"2011","EX7","EX7","Total",12432,5869,6563,12022,410,143,2034.6,6.1
"2011","EX8","EX8","Total",37449,18142,19307,35923,1526,429,2372.61,15.8
"2011","EX9","EX9","Total",6763,3088,3675,6621,142,86,2933.26,2.3
"2011","FY1","FY1","Total",33634,17445,16189,31475,2159,165,524.46,64.1
"2011","FY2","FY2","Total",24559,11979,12580,24048,511,212,624.8,39.3
"2011","FY3","FY3","Total",31955,15442,16513,31636,319,319,1526.5,20.9
"2011","FY4","FY4","Total",43664,21087,22577,42673,991,326,1500.34,29.1
"2011","FY5","FY5","Total",44816,21383,23433,44426,390,497,1662.15,27
"2011","FY6","FY6","Total",28003,13519,14484,27640,363,416,5163.83,5.4
"2011","FY7","FY7","Total",25939,12656,13283,25331,608,196,979.98,26.5
"2011","FY8","FY8","Total",44053,21131,22922,43146,907,700,3983.39,11.1
"2011","GL1","GL1","Total",34152,17402,16750,33276,876,291,985.9,34.6
"2011","GL10","GL10","Total",13953,6905,7048,13600,353,198,5945.57,2.3
"2011","GL11","GL11","Total",18139,8949,9190,17998,141,294,5326.38,3.4
"2011","GL12","GL12","Total",15045,7601,7444,14170,875,309,10055.15,1.5
"2011","GL13","GL13","Total",5863,2917,2946,5824,39,88,7151.4,0.8
"2011","GL14","GL14","Total",15722,7796,7926,15526,196,158,9188.63,1.7
"2011","GL15","GL15","Total",20743,10158,10585,20610,133,248,11352.79,1.8
"2011","GL16","GL16","Total",13381,6547,6834,13272,109,156,5454.98,2.5
"2011","GL17","GL17","Total",11180,5536,5644,10979,201,105,4953.33,2.3
"2011","GL18","GL18","Total",7493,3657,3836,7395,98,128,8399.91,0.9
"2011","GL19","GL19","Total",9803,4806,4997,8877,926,245,15017.39,0.7
"2011","GL2","GL2","Total",51819,25417,26402,51097,722,767,15599.25,3.3
"2011","GL20","GL20","Total",28233,14055,14178,27910,323,393,12645.84,2.2
"2011","GL3","GL3","Total",30492,14814,15678,30057,435,437,3892.31,7.8
"2011","GL4","GL4","Total",47808,23346,24462,47475,333,549,6226.89,7.7
"2011","GL5","GL5","Total",31040,15373,15667,30763,277,488,2918.69,10.6
"2011","GL50","GL50","Total",22496,10917,11579,20897,1599,329,604.36,37.2
"2011","GL51","GL51","Total",51520,25184,26336,50583,937,583,5147.37,10
"2011","GL52","GL52","Total",43265,21059,22206,42735,530,694,7145.86,6.1
"2011","GL53","GL53","Total",19755,9554,10201,18955,800,465,4356.43,4.5
"2011","GL54","GL54","Total",22146,10733,11413,21957,189,525,45817.88,0.5
"2011","GL55","GL55","Total",5422,2570,2852,5335,87,99,7805.66,0.7
"2011","GL56","GL56","Total",8403,3999,4404,8346,57,174,13092.17,0.6
"2011","GL6","GL6","Total",24460,11794,12666,24202,258,565,14092.38,1.7
"2011","GL7","GL7","Total",42280,20616,21664,41241,1039,961,39976.38,1.1
"2011","GL8","GL8","Total",8541,4117,4424,8440,101,177,11822.53,0.7
"2011","GL9","GL9","Total",2667,1320,1347,2634,33,79,6393.77,0.4
"2011","GU1","GU1","Total",29169,14832,14337,28881,288,573,1306.7,22.3
"2011","GU10","GU10","Total",22238,10920,11318,21615,623,649,9897.4,2.2
"2011","GU11","GU11","Total",23292,11981,11311,21793,1499,274,1925.3,12.1
"2011","GU12","GU12","Total",31479,15605,15874,31388,91,248,1333.81,23.6
"2011","GU14","GU14","Total",54994,27085,27909,54684,310,685,1666.37,33
"2011","GU15","GU15","Total",34778,17467,17311,33561,1217,666,1836.43,18.9
"2011","GU16","GU16","Total",23767,11814,11953,23347,420,438,1603.35,14.8
"2011","GU17","GU17","Total",11101,5553,5548,10887,214,123,1421.05,7.8
"2011","GU18","GU18","Total",6791,3307,3484,6756,35,147,419.06,16.2
"2011","GU19","GU19","Total",5592,2791,2801,5508,84,89,865.13,6.5
"2011","GU2","GU2","Total",34172,17102,17070,29903,4269,552,975.17,35
"2011","GU20","GU20","Total",4392,2185,2207,4329,63,150,955.33,4.6
"2011","GU21","GU21","Total",49738,24688,25050,49457,281,752,1873.49,26.5
"2011","GU22","GU22","Total",33400,16679,16721,32937,463,644,2783.31,12
"2011","GU23","GU23","Total",6869,3274,3595,6552,317,143,3283.4,2.1
"2011","GU24","GU24","Total",17845,9327,8518,16566,1279,369,6500.19,2.7
"2011","GU25","GU25","Total",5448,2659,2789,5310,138,188,1038.64,5.2
"2011","GU26","GU26","Total",7475,3583,3892,6913,562,182,1479.59,5.1
"2011","GU27","GU27","Total",17725,8544,9181,17274,451,510,6193.06,2.9
"2011","GU28","GU28","Total",6650,3188,3462,6447,203,180,11459.49,0.6
"2011","GU29","GU29","Total",9094,4267,4827,8999,95,211,8520.25,1.1
"2011","GU3","GU3","Total",11071,5382,5689,10776,295,255,5829.39,1.9
"2011","GU30","GU30","Total",9081,4410,4671,8974,107,273,4617.34,2
"2011","GU31","GU31","Total",11223,5383,5840,11164,59,318,8588.05,1.3
"2011","GU32","GU32","Total",11969,5763,6206,11423,546,310,8650.86,1.4
"2011","GU33","GU33","Total",8442,3998,4444,8058,384,186,4760.26,1.8
"2011","GU34","GU34","Total",29783,14556,15227,29282,501,684,18351.23,1.6
"2011","GU35","GU35","Total",23068,11512,11556,22687,381,389,5893.97,3.9
"2011","GU4","GU4","Total",15894,7590,8304,15833,61,421,3719.63,4.3
"2011","GU46","GU46","Total",14829,7243,7586,14827,2,285,871.58,17
"2011","GU47","GU47","Total",18862,9291,9571,18679,183,317,974.75,19.4
"2011","GU5","GU5","Total",11220,5350,5870,10892,328,337,6841.12,1.6
"2011","GU51","GU51","Total",23604,11664,11940,23384,220,478,1708.24,13.8
"2011","GU52","GU52","Total",15953,7835,8118,15858,95,312,1120,14.2
"2011","GU6","GU6","Total",14204,6934,7270,13587,617,340,5822.5,2.4
"2011","GU7","GU7","Total",22824,11362,11462,21687,1137,521,1961.94,11.6
"2011","GU8","GU8","Total",17648,8628,9020,17084,564,549,13687.07,1.3
"2011","GU9","GU9","Total",29684,14413,15271,29131,553,528,1825.92,16.3
"2011","HA0","HA0","Total",48358,24994,23364,48200,158,530,677.47,71.4
"2011","HA1","HA1","Total",39209,20001,19208,37531,1678,598,790.79,49.6
"2011","HA2","HA2","Total",55268,27267,28001,55137,131,874,865.37,63.9
"2011","HA3","HA3","Total",69554,34305,35249,69012,542,1155,1297.6,53.6
"2011","HA4","HA4","Total",50175,24482,25693,49514,661,700,1751.76,28.6
"2011","HA5","HA5","Total",44985,21705,23280,44734,251,1104,1318.42,34.1
"2011","HA6","HA6","Total",21984,10546,11438,21513,471,593,1371.49,16
"2011","HA7","HA7","Total",37197,17999,19198,36833,364,724,1423.64,26.1
"2011","HA8","HA8","Total",66378,32374,34004,66001,377,1040,971.12,68.4
"2011","HA9","HA9","Total",47845,24557,23288,47267,578,553,810.92,59
"2011","HD1","HD1","Total",22962,12166,10796,21562,1400,154,622.64,36.9
"2011","HD2","HD2","Total",29503,14468,15035,29216,287,295,1564.77,18.9
"2011","HD3","HD3","Total",29289,14179,15110,29086,203,331,1215.65,24.1
"2011","HD4","HD4","Total",30275,14874,15401,29899,376,283,2842.62,10.7
"2011","HD5","HD5","Total",31056,15119,15937,30883,173,239,1599.02,19.4
"2011","HD6","HD6","Total",27344,13436,13908,27077,267,325,2020.36,13.5
"2011","HD7","HD7","Total",22676,11212,11464,22590,86,243,6426.84,3.5
"2011","HD8","HD8","Total",34320,16927,17393,33003,1317,560,7359.52,4.7
"2011","HD9","HD9","Total",35389,17392,17997,35157,232,589,9003.42,3.9
"2011","HG1","HG1","Total",34201,16755,17446,33406,795,474,1354.96,25.2
"2011","HG2","HG2","Total",33473,15853,17620,32640,833,659,1451.51,23.1
"2011","HG3","HG3","Total",26400,12936,13464,26080,320,527,48482.89,0.5
"2011","HG4","HG4","Total",25852,12845,13007,25012,840,406,34856.54,0.7
"2011","HG5","HG5","Total",18417,8964,9453,18260,157,381,8007.42,2.3
"2011","HP1","HP1","Total",24413,11983,12430,24271,142,416,1744.31,14
"2011","HP10","HP10","Total",18965,9182,9783,18903,62,435,1956.08,9.7
"2011","HP11","HP11","Total",13505,6572,6933,12365,1140,228,681.73,19.8
"2011","HP12","HP12","Total",22822,11510,11312,22673,149,284,1052.15,21.7
"2011","HP13","HP13","Total",43059,21506,21553,42498,561,571,1348.36,31.9
"2011","HP14","HP14","Total",17723,8841,8882,17410,313,457,8031.41,2.2
"2011","HP15","HP15","Total",17428,8437,8991,17324,104,385,1652.39,10.5
"2011","HP16","HP16","Total",11846,5738,6108,11757,89,396,4827.6,2.5
"2011","HP17","HP17","Total",10044,4875,5169,9945,99,243,7424.3,1.4
"2011","HP18","HP18","Total",13522,6890,6632,12969,553,352,17990.48,0.8
"2011","HP19","HP19","Total",23757,11749,12008,23518,239,218,1840.84,12.9
"2011","HP2","HP2","Total",38432,18830,19602,37906,526,407,2662.73,14.4
"2011","HP20","HP20","Total",14908,7567,7341,14503,405,137,328.46,45.4
"2011","HP21","HP21","Total",33355,16507,16848,33131,224,434,731.68,45.6
"2011","HP22","HP22","Total",24698,11945,12753,24143,555,575,13547.27,1.8
"2011","HP23","HP23","Total",17459,8461,8998,17215,244,461,6567.74,2.7
"2011","HP27","HP27","Total",12211,5883,6328,12013,198,272,4309.05,2.8
"2011","HP3","HP3","Total",32094,16207,15887,31254,840,444,3587.41,8.9
"2011","HP4","HP4","Total",23973,11661,12312,23795,178,598,5216.66,4.6
"2011","HP5","HP5","Total",25390,12575,12815,25266,124,471,5245.43,4.8
"2011","HP6","HP6","Total",14150,6815,7335,13985,165,420,1001.24,14.1
"2011","HP7","HP7","Total",10625,5179,5446,10570,55,238,3850.71,2.8
"2011","HP8","HP8","Total",6819,3306,3513,6819,0,232,1431.88,4.8
"2011","HP9","HP9","Total",17153,8318,8835,16858,295,595,2795.59,6.1
"2011","HR1","HR1","Total",31885,15658,16227,30945,940,616,19809.87,1.6
"2011","HR2","HR2","Total",39121,19363,19758,38883,238,527,47631.58,0.8
"2011","HR3","HR3","Total",7756,3820,3936,7704,52,147,27642.53,0.3
"2011","HR4","HR4","Total",30339,15105,15234,30046,293,433,20799.84,1.5
"2011","HR5","HR5","Total",4670,2255,2415,4517,153,74,12795.95,0.4
"2011","HR6","HR6","Total",20493,10040,10453,20251,242,289,30312.06,0.7
"2011","HR7","HR7","Total",7155,3534,3621,6934,221,110,13254.58,0.5
"2011","HR8","HR8","Total",14015,6849,7166,13828,187,249,16085.51,0.9
"2011","HR9","HR9","Total",21059,10268,10791,20655,404,369,17523.87,1.2
"2011","HU1","HU1","Total",3294,1997,1297,3081,213,36,154.51,21.3
"2011","HU10","HU10","Total",19057,9217,9840,18855,202,253,1446.43,13.2
"2011","HU11","HU11","Total",11858,5839,6019,11825,33,128,15964.86,0.7
"2011","HU12","HU12","Total",25596,12602,12994,25258,338,266,26215.86,1
"2011","HU13","HU13","Total",15000,7222,7778,14663,337,204,572.04,26.2
"2011","HU14","HU14","Total",8278,4073,4205,8206,72,190,2452.28,3.4
"2011","HU15","HU15","Total",24147,12154,11993,23295,852,375,9550.01,2.5
"2011","HU16","HU16","Total",16466,7897,8569,14992,1474,281,3003.18,5.5
"2011","HU17","HU17","Total",43499,21061,22438,42720,779,773,17221.14,2.5
"2011","HU18","HU18","Total",8774,4234,4540,8564,210,108,2483.57,3.5
"2011","HU19","HU19","Total",7135,3558,3577,6953,182,44,3428.71,2.1
"2011","HU2","HU2","Total",4017,2214,1803,3941,76,8,128.26,31.3
"2011","HU20","HU20","Total",1015,478,537,986,29,27,2599.86,0.4
"2011","HU3","HU3","Total",27335,14425,12910,26821,514,149,701.78,39
"2011","HU4","HU4","Total",23208,11268,11940,23002,206,144,652.74,35.6
"2011","HU5","HU5","Total",51064,25772,25292,50735,329,417,994.79,51.3
"2011","HU6","HU6","Total",33975,16760,17215,33480,495,236,1007.53,33.7
"2011","HU7","HU7","Total",42282,20710,21572,41918,364,186,3235.63,13.1
"2011","HU8","HU8","Total",34815,17085,17730,34540,275,197,926.29,37.6
"2011","HU9","HU9","Total",42408,21104,21304,41216,1192,161,1485.51,28.5
"2011","HX1","HX1","Total",24131,12177,11954,23905,226,152,456.61,52.8
"2011","HX2","HX2","Total",35876,17363,18513,35761,115,286,4559.69,7.9
"2011","HX3","HX3","Total",45943,22415,23528,45579,364,535,3373.8,13.6
"2011","HX4","HX4","Total",12176,5934,6242,12124,52,158,2384.21,5.1
"2011","HX5","HX5","Total",10261,4948,5313,10192,69,76,810.28,12.7
"2011","HX6","HX6","Total",18688,9187,9501,18548,140,242,6288.49,3
"2011","HX7","HX7","Total",13303,6384,6919,13292,11,187,11286.59,1.2
"2011","IG1","IG1","Total",64550,32854,31696,64125,425,643,697.26,92.6
"2011","IG10","IG10","Total",31527,15213,16314,31420,107,438,2137.18,14.8
"2011","IG11","IG11","Total",53359,26882,26477,53217,142,483,1121.03,47.6
"2011","IG2","IG2","Total",28968,14379,14589,28666,302,463,358.8,80.7
"2011","IG3","IG3","Total",36068,18346,17722,35792,276,433,517.29,69.7
"2011","IG4","IG4","Total",8912,4438,4474,8912,0,176,161.9,55
"2011","IG5","IG5","Total",17014,8316,8698,16972,42,340,284.35,59.8
"2011","IG6","IG6","Total",26769,12903,13866,26714,55,326,977.1,27.4
"2011","IG7","IG7","Total",20397,9770,10627,20243,154,302,1667.58,12.2
"2011","IG8","IG8","Total",35245,17153,18092,35070,175,617,898.45,39.2
"2011","IG9","IG9","Total",12885,6162,6723,12698,187,224,442.99,29.1
"2011","IP1","IP1","Total",39543,19978,19565,38648,895,350,1705.09,23.2
"2011","IP10","IP10","Total",3058,1530,1528,3005,53,68,4553.44,0.7
"2011","IP11","IP11","Total",29296,14135,15161,28825,471,373,3256.94,9
"2011","IP12","IP12","Total",24397,12138,12259,23314,1083,451,23034.49,1.1
"2011","IP13","IP13","Total",18132,8863,9269,17726,406,436,26207.65,0.7
"2011","IP14","IP14","Total",39003,19139,19864,38629,374,611,25467.65,1.5
"2011","IP15","IP15","Total",2466,1115,1351,2424,42,32,968.83,2.5
"2011","IP16","IP16","Total",6546,3166,3380,6417,129,75,3647.33,1.8
"2011","IP17","IP17","Total",10784,5199,5585,10649,135,177,16453.55,0.7
"2011","IP18","IP18","Total",4060,1840,2220,3946,114,62,2210.57,1.8
"2011","IP19","IP19","Total",10281,5006,5275,10161,120,160,16934.86,0.6
"2011","IP2","IP2","Total",31133,15429,15704,30724,409,221,1865.89,16.7
"2011","IP20","IP20","Total",7792,3791,4001,7762,30,68,8155.62,1
"2011","IP21","IP21","Total",11220,5599,5621,11142,78,160,17746.8,0.6
"2011","IP22","IP22","Total",21876,10691,11185,21691,185,279,22109.25,1
"2011","IP23","IP23","Total",7010,3431,3579,6926,84,130,10141.15,0.7
"2011","IP24","IP24","Total",27825,13811,14014,27632,193,216,21026.25,1.3
"2011","IP25","IP25","Total",18213,9315,8898,17117,1096,165,15493.01,1.2
"2011","IP26","IP26","Total",8945,4438,4507,8844,101,91,26967.85,0.3
"2011","IP27","IP27","Total",19013,9741,9272,17887,1126,109,15464.19,1.2
"2011","IP28","IP28","Total",24498,12299,12199,23983,515,242,20689.31,1.2
"2011","IP29","IP29","Total",9017,4430,4587,8947,70,202,15922.71,0.6
"2011","IP3","IP3","Total",34573,17099,17474,34011,562,308,1453.35,23.8
"2011","IP30","IP30","Total",13574,6702,6872,13570,4,255,12795.99,1.1
"2011","IP31","IP31","Total",21299,10830,10469,20368,931,412,18966.89,1.1
"2011","IP32","IP32","Total",17091,8481,8610,17045,46,189,697.23,24.5
"2011","IP33","IP33","Total",24205,11813,12392,23819,386,389,1395.59,17.3
"2011","IP4","IP4","Total",36366,17987,18379,35960,406,558,1066.34,34.1
"2011","IP5","IP5","Total",19649,9621,10028,19541,108,332,1257.62,15.6
"2011","IP6","IP6","Total",16179,7965,8214,16022,157,258,13024.82,1.2
"2011","IP7","IP7","Total",16621,8530,8091,15696,925,332,14469.57,1.1
"2011","IP8","IP8","Total",10920,5391,5529,10868,52,159,7479.22,1.5
"2011","IP9","IP9","Total",11349,5577,5772,10762,587,255,7646.38,1.5
"2011","KT1","KT1","Total",23898,11771,12127,23204,694,340,443.73,53.9
"2011","KT10","KT10","Total",20893,10168,10725,20745,148,660,1790.19,11.7
"2011","KT11","KT11","Total",14980,7268,7712,14595,385,507,2607.87,5.7
"2011","KT12","KT12","Total",36834,17790,19044,36562,272,609,2013.97,18.3
"2011","KT13","KT13","Total",21292,10393,10899,21043,249,454,1338.48,15.9
"2011","KT14","KT14","Total",13350,6444,6906,13248,102,242,636.42,21
"2011","KT15","KT15","Total",27373,13368,14005,27118,255,360,1365.43,20
"2011","KT16","KT16","Total",18462,9098,9364,18223,239,219,2719.68,6.8
"2011","KT17","KT17","Total",23302,11351,11951,22723,579,466,1090.37,21.4
"2011","KT18","KT18","Total",17445,8266,9179,17135,310,321,1918.58,9.1
"2011","KT19","KT19","Total",34098,16667,17431,33886,212,479,1063.77,32.1
"2011","KT2","KT2","Total",30450,14881,15569,29414,1036,618,615.18,49.5
"2011","KT20","KT20","Total",20559,10009,10550,20202,357,399,3324.95,6.2
"2011","KT21","KT21","Total",13726,6592,7134,13481,245,362,1145.88,12
"2011","KT22","KT22","Total",24154,11978,12176,23742,412,639,3015.74,8
"2011","KT23","KT23","Total",10694,5076,5618,10632,62,249,1073.16,10
"2011","KT24","KT24","Total",9515,4551,4964,9370,145,393,3015.32,3.2
"2011","KT3","KT3","Total",38508,18712,19796,38171,337,767,799.33,48.2
"2011","KT4","KT4","Total",28910,14158,14752,28844,66,396,549.65,52.6
"2011","KT5","KT5","Total",20419,10143,10276,19644,775,329,444.45,45.9
"2011","KT6","KT6","Total",31422,15426,15996,30174,1248,406,659.41,47.7
"2011","KT7","KT7","Total",10365,4994,5371,10240,125,245,321.12,32.3
"2011","KT8","KT8","Total",19646,9486,10160,19544,102,337,935.01,21
"2011","KT9","KT9","Total",21369,10369,11000,21303,66,259,988.48,21.6
"2011","L1","L1","Total",7074,3944,3130,6450,624,66,156.05,45.3
"2011","L10","L10","Total",15093,7257,7836,15059,34,68,691.12,21.8
"2011","L11","L11","Total",25226,11643,13583,25031,195,100,538.69,46.8
"2011","L12","L12","Total",31797,15224,16573,31630,167,259,955.28,33.3
"2011","L13","L13","Total",30565,15025,15540,30192,373,147,493.77,61.9
"2011","L14","L14","Total",25142,11657,13485,24881,261,115,475.32,52.9
"2011","L15","L15","Total",30009,15039,14970,29892,117,259,430.84,69.7
"2011","L16","L16","Total",15115,7185,7930,14595,520,197,451.35,33.5
"2011","L17","L17","Total",24159,12144,12015,22950,1209,203,615.84,39.2
"2011","L18","L18","Total",28413,13774,14639,26959,1454,464,645.89,44
"2011","L19","L19","Total",23729,11595,12134,23557,172,217,762.97,31.1
"2011","L2","L2","Total",566,334,232,566,0,4,14.93,37.9
"2011","L20","L20","Total",31565,15306,16259,31235,330,147,835.67,37.8
"2011","L21","L21","Total",25556,12237,13319,25484,72,147,678.42,37.7
"2011","L22","L22","Total",13793,6827,6966,13605,188,140,343.79,40.1
"2011","L23","L23","Total",30221,14281,15940,29867,354,491,1603.88,18.8
"2011","L24","L24","Total",15964,7517,8447,15898,66,57,1515.55,10.5
"2011","L25","L25","Total",33447,16076,17371,33062,385,296,1064.62,31.4
"2011","L26","L26","Total",15150,7361,7789,15146,4,89,915.47,16.5
"2011","L27","L27","Total",6427,2924,3503,6344,83,21,251.68,25.5
"2011","L28","L28","Total",6274,2973,3301,6274,0,21,163.78,38.3
"2011","L29","L29","Total",404,192,212,404,0,2,489.98,0.8
"2011","L3","L3","Total",17830,9565,8265,12911,4919,214,583.62,30.6
"2011","L30","L30","Total",19872,9327,10545,19640,232,120,569.35,34.9
"2011","L31","L31","Total",30801,14985,15816,30173,628,287,2382.19,12.9
"2011","L32","L32","Total",20447,9613,10834,20408,39,68,737.48,27.7
"2011","L33","L33","Total",16939,7838,9101,16881,58,50,1881.91,9
"2011","L34","L34","Total",12015,5852,6163,11900,115,130,2030.99,5.9
"2011","L35","L35","Total",31064,15063,16001,30787,277,254,2454.74,12.7
"2011","L36","L36","Total",39929,18784,21145,39517,412,234,1212.25,32.9
"2011","L37","L37","Total",23542,11248,12294,23278,264,467,3904.64,6
"2011","L38","L38","Total",2579,1253,1326,2546,33,51,1219.15,2.1
"2011","L39","L39","Total",28676,13690,14986,27405,1271,498,9264.79,3.1
"2011","L4","L4","Total",40268,19519,20749,40051,217,136,635.36,63.4
"2011","L40","L40","Total",18033,8912,9121,17831,202,238,10184.99,1.8
"2011","L5","L5","Total",12448,6154,6294,12395,53,47,373.99,33.3
"2011","L6","L6","Total",23727,12120,11607,22458,1269,129,361.42,65.6
"2011","L7","L7","Total",18006,9252,8754,16027,1979,157,381.4,47.2
"2011","L8","L8","Total",32577,16980,15597,31707,870,160,463.56,70.3
"2011","L9","L9","Total",32637,16954,15683,31040,1597,122,785.02,41.6
"2011","LA1","LA1","Total",52049,25219,26830,46812,5237,751,2555.67,20.4
"2011","LA10","LA10","Total",4002,2066,1936,3550,452,90,27434.11,0.1
"2011","LA11","LA11","Total",9673,4632,5041,9434,239,151,10653.91,0.9
"2011","LA12","LA12","Total",20194,9925,10269,19903,291,346,23960.38,0.8
"2011","LA13","LA13","Total",18812,9292,9520,18703,109,261,2497.21,7.5
"2011","LA14","LA14","Total",38513,19066,19447,38004,509,337,2854.24,13.5
"2011","LA15","LA15","Total",7827,3863,3964,7782,45,91,609.8,12.8
"2011","LA16","LA16","Total",3462,1723,1739,3430,32,45,1923.14,1.8
"2011","LA17","LA17","Total",1174,577,597,1174,0,10,3901.39,0.3
"2011","LA18","LA18","Total",9070,4721,4349,8445,625,85,9497.48,1
"2011","LA19","LA19","Total",972,475,497,958,14,10,5275.31,0.2
"2011","LA2","LA2","Total",22304,10853,11451,19615,2689,432,48188.53,0.5
"2011","LA20","LA20","Total",1159,581,578,1159,0,37,12235.89,0.1
"2011","LA21","LA21","Total",928,464,464,899,29,20,4093.32,0.2
"2011","LA22","LA22","Total",4943,2450,2493,4562,381,84,13860.88,0.4
"2011","LA23","LA23","Total",9137,4440,4697,8494,643,167,8886.34,1
"2011","LA3","LA3","Total",24447,11912,12535,24153,294,236,3116.64,7.8
"2011","LA4","LA4","Total",26392,12541,13851,25817,575,195,683.64,38.6
"2011","LA5","LA5","Total",16416,7878,8538,16198,218,211,6571.71,2.5
"2011","LA6","LA6","Total",12506,6009,6497,12147,359,252,31910.12,0.4
"2011","LA7","LA7","Total",5317,2559,2758,5073,244,89,5069.19,1
"2011","LA8","LA8","Total",9008,4448,4560,8930,78,166,35119.68,0.3
"2011","LA9","LA9","Total",30399,14745,15654,29964,435,469,2006.8,15.1
"2011","LE1","LE1","Total",13308,6751,6557,11198,2110,134,299.47,44.4
"2011","LE10","LE10","Total",47474,23419,24055,47231,243,503,6166.92,7.7
"2011","LE11","LE11","Total",60367,31285,29082,54227,6140,968,3011.66,20
"2011","LE12","LE12","Total",62122,30323,31799,60608,1514,967,22699.48,2.7
"2011","LE13","LE13","Total",27158,13313,13845,26866,292,269,2306.19,11.8
"2011","LE14","LE14","Total",17321,8523,8798,17190,131,340,35230.07,0.5
"2011","LE15","LE15","Total",32325,16423,15902,29315,3010,736,34050.96,0.9
"2011","LE16","LE16","Total",34975,17424,17551,33897,1078,688,28705.35,1.2
"2011","LE17","LE17","Total",20648,10324,10324,20495,153,393,18733.47,1.1
"2011","LE18","LE18","Total",32861,16140,16721,31968,893,311,2348.49,14
"2011","LE19","LE19","Total",14762,7248,7514,14675,87,172,1801.42,8.2
"2011","LE2","LE2","Total",119026,58534,60492,112536,6490,1706,3870.43,30.8
"2011","LE3","LE3","Total",100913,49826,51087,100073,840,919,2784.81,36.2
"2011","LE4","LE4","Total",97057,47572,49485,96530,527,1118,3148.89,30.8
"2011","LE5","LE5","Total",85435,42239,43196,84846,589,853,1669.89,51.2
"2011","LE6","LE6","Total",12073,5871,6202,12073,0,172,3819.15,3.2
"2011","LE65","LE65","Total",14025,6862,7163,13832,193,242,4100.15,3.4
"2011","LE67","LE67","Total",58904,29074,29830,58491,413,623,12413.44,4.7
"2011","LE7","LE7","Total",44781,21837,22944,44449,332,789,24251.34,1.8
"2011","LE8","LE8","Total",35013,16942,18071,34699,314,549,10914.99,3.2
"2011","LE9","LE9","Total",55247,27089,28158,54768,479,644,12863.03,4.3
"2011","LN1","LN1","Total",28362,13780,14582,26971,1391,398,15186.85,1.9
"2011","LN10","LN10","Total",5985,2889,3096,5809,176,111,8846.24,0.7
"2011","LN11","LN11","Total",28222,13698,14524,27943,279,393,42508.76,0.7
"2011","LN12","LN12","Total",13221,6315,6906,12906,315,83,4377,3
"2011","LN13","LN13","Total",7766,3765,4001,7643,123,84,17449.37,0.4
"2011","LN2","LN2","Total",38637,18928,19709,37341,1296,507,8280.43,4.7
"2011","LN3","LN3","Total",8895,4332,4563,8706,189,86,9205.53,1
"2011","LN4","LN4","Total",38658,19118,19540,37628,1030,510,39540.42,1
"2011","LN5","LN5","Total",32187,15950,16237,31314,873,398,17530.24,1.8
"2011","LN6","LN6","Total",58349,28241,30108,55092,3257,575,11382.73,5.1
"2011","LN7","LN7","Total",6070,3010,3060,6005,65,125,13869.7,0.4
"2011","LN8","LN8","Total",17283,8491,8792,16944,339,248,48864.76,0.4
"2011","LN9","LN9","Total",9675,4691,4984,9552,123,111,17382.5,0.6
"2011","LS1","LS1","Total",5759,2891,2868,3247,2512,81,138.77,41.5
"2011","LS10","LS10","Total",35534,17265,18269,34770,764,149,1632.67,21.8
"2011","LS11","LS11","Total",34795,17776,17019,34628,167,168,926.98,37.5
"2011","LS12","LS12","Total",40949,20616,20333,40026,923,205,1580.5,25.9
"2011","LS13","LS13","Total",35021,16988,18033,34948,73,187,1004.14,34.9
"2011","LS14","LS14","Total",34484,16434,18050,34331,153,254,2892.6,11.9
"2011","LS15","LS15","Total",34991,16849,18142,34916,75,381,5143.97,6.8
"2011","LS16","LS16","Total",36457,17624,18833,34973,1484,636,3303.36,11
"2011","LS17","LS17","Total",43426,20956,22470,43317,109,896,7085.96,6.1
"2011","LS18","LS18","Total",18895,9109,9786,18613,282,247,806.58,23.4
"2011","LS19","LS19","Total",19835,9600,10235,19700,135,255,1795.86,11
"2011","LS2","LS2","Total",10120,5129,4991,6133,3987,151,190.49,53.1
"2011","LS20","LS20","Total",12663,6151,6512,12565,98,200,1579.13,8
"2011","LS21","LS21","Total",17729,8619,9110,17638,91,288,10659.07,1.7
"2011","LS22","LS22","Total",15791,7707,8084,15487,304,334,7502.01,2.1
"2011","LS23","LS23","Total",9207,4806,4401,8361,846,177,3901.33,2.4
"2011","LS24","LS24","Total",11849,5808,6041,11809,40,208,11964.84,1
"2011","LS25","LS25","Total",39917,19405,20512,39719,198,461,10757.03,3.7
"2011","LS26","LS26","Total",30021,14500,15521,29810,211,241,2603.06,11.5
"2011","LS27","LS27","Total",35695,17356,18339,35486,209,233,2081.94,17.1
"2011","LS28","LS28","Total",37896,18122,19774,37544,352,345,1902.51,19.9
"2011","LS29","LS29","Total",31456,15050,16406,31044,412,837,7772.1,4
"2011","LS3","LS3","Total",2876,1466,1410,2399,477,27,53.35,53.9
"2011","LS4","LS4","Total",9072,4734,4338,8985,87,47,181.48,50
"2011","LS5","LS5","Total",8507,4243,4264,7488,1019,85,210.3,40.5
"2011","LS6","LS6","Total",48277,23803,24474,44504,3773,550,792.06,61
"2011","LS7","LS7","Total",28266,13709,14557,27726,540,275,610.79,46.3
"2011","LS8","LS8","Total",48286,23745,24541,47807,479,633,1231.54,39.2
"2011","LS9","LS9","Total",36406,18295,18111,35881,525,164,950.12,38.3
"2011","LU1","LU1","Total",43355,22688,20667,42577,778,426,2240.36,19.4
"2011","LU2","LU2","Total",56890,28332,28558,56702,188,754,4819.47,11.8
"2011","LU3","LU3","Total",60550,29987,30563,60125,425,724,3344.28,18.1
"2011","LU4","LU4","Total",52069,25717,26352,51769,300,476,1302.35,40
"2011","LU5","LU5","Total",38285,18840,19445,38085,200,434,4011.32,9.5
"2011","LU6","LU6","Total",30833,15173,15660,30661,172,456,5482.62,5.6
"2011","LU7","LU7","Total",53968,26728,27240,53566,402,875,17016.44,3.2
"2011","M1","M1","Total",12221,6902,5319,8700,3521,127,180.76,67.6
"2011","M11","M11","Total",20443,10022,10421,20315,128,107,648.92,31.5
"2011","M12","M12","Total",16176,8436,7740,16052,124,105,399.97,40.4
"2011","M13","M13","Total",23961,12067,11894,19914,4047,241,314.67,76.1
"2011","M14","M14","Total",52820,26597,26223,46991,5829,443,603.79,87.5
"2011","M15","M15","Total",22310,12075,10235,18274,4036,187,300.18,74.3
"2011","M16","M16","Total",35721,17776,17945,35182,539,313,569.84,62.7
"2011","M18","M18","Total",23267,11453,11814,23079,188,139,463.2,50.2
"2011","M19","M19","Total",34586,17090,17496,34485,101,277,539.59,64.1
"2011","M20","M20","Total",48595,24482,24113,48033,562,519,967.26,50.2
"2011","M21","M21","Total",29583,14407,15176,29459,124,306,714.11,41.4
"2011","M22","M22","Total",42371,20356,22015,42069,302,186,1302.72,32.5
"2011","M23","M23","Total",30949,15009,15940,30762,187,187,849.79,36.4
"2011","M24","M24","Total",46748,22729,24019,46457,291,400,2052.94,22.8
"2011","M25","M25","Total",31475,15394,16081,30997,478,509,1082,29.1
"2011","M26","M26","Total",34813,17102,17711,34637,176,305,1731.36,20.1
"2011","M27","M27","Total",42069,20937,21132,41044,1025,278,1530.98,27.5
"2011","M28","M28","Total",39425,19242,20183,39291,134,446,2544.8,15.5
"2011","M29","M29","Total",22896,11447,11449,22845,51,230,2327.05,9.8
"2011","M3","M3","Total",11709,6806,4903,10954,755,93,274.01,42.7
"2011","M30","M30","Total",35983,17808,18175,35630,353,250,1229,29.3
"2011","M31","M31","Total",8395,3976,4419,8360,35,50,1202.38,7
"2011","M32","M32","Total",28586,14069,14517,28530,56,273,1032.11,27.7
"2011","M33","M33","Total",60474,29745,30729,60239,235,919,1630.13,37.1
"2011","M34","M34","Total",46290,22431,23859,46071,219,378,1538.78,30.1
"2011","M35","M35","Total",20680,9992,10688,20542,138,150,681.9,30.3
"2011","M38","M38","Total",12958,6202,6756,12897,61,57,383.38,33.8
"2011","M4","M4","Total",10740,6109,4631,10557,183,43,204.99,52.4
"2011","M40","M40","Total",40857,20014,20843,40427,430,261,1061.97,38.5
"2011","M41","M41","Total",41481,20148,21333,41087,394,452,2004.86,20.7
"2011","M43","M43","Total",23255,11286,11969,23178,77,194,546.02,42.6
"2011","M44","M44","Total",19689,9614,10075,19659,30,119,2031.3,9.7
"2011","M45","M45","Total",22722,10884,11838,22635,87,321,966.49,23.5
"2011","M46","M46","Total",22203,11148,11055,22049,154,157,937.52,23.7
"2011","M5","M5","Total",15729,7946,7783,15493,236,59,538.99,29.2
"2011","M50","M50","Total",3449,1955,1494,3449,0,12,155.76,22.1
"2011","M6","M6","Total",31974,16157,15817,29468,2506,257,691.72,46.2
"2011","M60","M60","Total",1437,1105,332,269,1168,6,21.09,68.1
"2011","M7","M7","Total",27746,13747,13999,27048,698,524,569.04,48.8
"2011","M8","M8","Total",31098,15905,15193,30870,228,229,933.08,33.3
"2011","M9","M9","Total",39518,19282,20236,39270,248,192,1040.53,38
"2011","ME1","ME1","Total",31192,15593,15599,29803,1389,367,2231.24,14
"2011","ME10","ME10","Total",47582,23303,24279,47162,420,411,1935.13,24.6
"2011","ME11","ME11","Total",3407,1671,1736,3407,0,22,720.59,4.7
"2011","ME12","ME12","Total",36884,18773,18111,35336,1548,234,8366.08,4.4
"2011","ME13","ME13","Total",27959,13525,14434,27648,311,333,14747.86,1.9
"2011","ME14","ME14","Total",31714,16075,15639,30541,1173,517,4610.1,6.9
"2011","ME15","ME15","Total",47659,23234,24425,47287,372,421,3684.37,12.9
"2011","ME16","ME16","Total",30046,14678,15368,29433,613,391,1238.71,24.3
"2011","ME17","ME17","Total",22389,11062,11327,22014,375,322,14358.31,1.6
"2011","ME18","ME18","Total",6803,3327,3476,6756,47,136,3941.22,1.7
"2011","ME19","ME19","Total",21797,10646,11151,21697,100,306,4475.25,4.9
"2011","ME2","ME2","Total",39529,19336,20193,39300,229,340,2731.75,14.5
"2011","ME20","ME20","Total",20645,10132,10513,20525,120,207,2249.33,9.2
"2011","ME3","ME3","Total",26184,12856,13328,26050,134,273,11796.52,2.2
"2011","ME4","ME4","Total",30191,15604,14587,29007,1184,244,723.89,41.7
"2011","ME5","ME5","Total",51409,25271,26138,51345,64,504,1780.76,28.9
"2011","ME6","ME6","Total",10211,4941,5270,10122,89,64,880.11,11.6
"2011","ME7","ME7","Total",51775,25930,25845,50816,959,527,1607.59,32.2
"2011","ME8","ME8","Total",49214,23837,25377,49077,137,479,1910.31,25.8
"2011","ME9","ME9","Total",20553,10156,10397,20377,176,250,15463.06,1.3
"2011","MK1","MK1","Total",585,333,252,562,23,7,44.73,13.1
"2011","MK10","MK10","Total",13825,6988,6837,13819,6,162,786.07,17.6
"2011","MK11","MK11","Total",7736,3776,3960,7671,65,98,252.6,30.6
"2011","MK12","MK12","Total",12492,6148,6344,12476,16,101,672.65,18.6
"2011","MK13","MK13","Total",18860,9409,9451,18851,9,227,601.06,31.4
"2011","MK14","MK14","Total",18700,9162,9538,18488,212,272,896.28,20.9
"2011","MK15","MK15","Total",7205,3522,3683,7160,45,142,602.51,12
"2011","MK16","MK16","Total",18500,8988,9512,18284,216,314,7760.02,2.4
"2011","MK17","MK17","Total",17229,8469,8760,17010,219,375,17726.34,1
"2011","MK18","MK18","Total",30663,15217,15446,29478,1185,798,23828.7,1.3
"2011","MK19","MK19","Total",11258,5585,5673,11256,2,174,8198.28,1.4
"2011","MK2","MK2","Total",14316,6917,7399,14253,63,117,666.26,21.5
"2011","MK3","MK3","Total",22625,10990,11635,22479,146,251,876.25,25.8
"2011","MK4","MK4","Total",21867,11004,10863,21434,433,285,835.58,26.2
"2011","MK40","MK40","Total",31009,15761,15248,29369,1640,520,1227.02,25.3
"2011","MK41","MK41","Total",42537,20581,21956,41713,824,624,2971.25,14.3
"2011","MK42","MK42","Total",44558,21652,22906,44337,221,404,2556.74,17.4
"2011","MK43","MK43","Total",32983,16524,16459,32281,702,599,19122.61,1.7
"2011","MK44","MK44","Total",15317,7502,7815,15183,134,383,22545.63,0.7
"2011","MK45","MK45","Total",43049,21322,21727,42905,144,830,13761.02,3.1
"2011","MK46","MK46","Total",9126,4423,4703,9027,99,203,6270.19,1.5
"2011","MK5","MK5","Total",15438,7510,7928,15383,55,334,638.55,24.2
"2011","MK6","MK6","Total",28113,14208,13905,27820,293,247,993.66,28.3
"2011","MK7","MK7","Total",14559,7154,7405,14393,166,231,713.3,20.4
"2011","MK8","MK8","Total",12062,6001,6061,11897,165,227,740.24,16.3
"2011","MK9","MK9","Total",3366,1950,1416,3363,3,25,280.78,12
"2011","N1","N1","Total",91056,44965,46091,89276,1780,853,612.17,148.7
"2011","N10","N10","Total",27992,13521,14471,27748,244,546,485.31,57.7
"2011","N11","N11","Total",29879,14838,15041,29480,399,303,473.67,63.1
"2011","N12","N12","Total",28898,14021,14877,28459,439,453,466.38,62
"2011","N13","N13","Total",31783,15584,16199,31513,270,407,426.5,74.5
"2011","N14","N14","Total",29956,14405,15551,29692,264,467,597.34,50.1
"2011","N15","N15","Total",43718,22082,21636,43360,358,387,365.34,119.7
"2011","N16","N16","Total",68567,33679,34888,68303,264,710,463.35,148
"2011","N17","N17","Total",63538,31178,32360,63197,341,555,718.9,88.4
"2011","N18","N18","Total",31742,15161,16581,31579,163,329,541.83,58.6
"2011","N19","N19","Total",33752,16166,17586,33653,99,331,243.37,138.7
"2011","N2","N2","Total",23968,11500,12468,23777,191,402,516.18,46.4
"2011","N20","N20","Total",19024,9129,9895,18861,163,430,979.82,19.4
"2011","N21","N21","Total",23500,11641,11859,23283,217,380,591.4,39.7
"2011","N22","N22","Total",42851,21054,21797,42655,196,380,430.48,99.5
"2011","N3","N3","Total",26534,12877,13657,26319,215,469,405.66,65.4
"2011","N4","N4","Total",47291,23801,23490,47019,272,351,412.98,114.5
"2011","N5","N5","Total",24287,11919,12368,24097,190,288,182.29,133.2
"2011","N6","N6","Total",19474,9580,9894,19173,301,347,518.38,37.6
"2011","N7","N7","Total",48157,23909,24248,46353,1804,402,336.81,143
"2011","N8","N8","Total",40037,19792,20245,39828,209,443,378.96,105.6
"2011","N9","N9","Total",52193,24938,27255,52030,163,545,736.21,70.9
"2011","NE1","NE1","Total",9051,5169,3882,6612,2439,125,238.58,37.9
"2011","NE10","NE10","Total",36221,17558,18663,36069,152,165,1315.76,27.5
"2011","NE11","NE11","Total",16459,7978,8481,16384,75,86,2535.25,6.5
"2011","NE12","NE12","Total",35096,16903,18193,34857,239,228,1502.39,23.4
"2011","NE13","NE13","Total",12851,6126,6725,12784,67,122,5716.19,2.2
"2011","NE15","NE15","Total",32691,15917,16774,32252,439,168,5200.09,6.3
"2011","NE16","NE16","Total",25674,12567,13107,25471,203,248,3046.69,8.4
"2011","NE17","NE17","Total",4669,2303,2366,4622,47,46,605.34,7.7
"2011","NE18","NE18","Total",927,447,480,924,3,19,3993.16,0.2
"2011","NE19","NE19","Total",2273,1132,1141,2252,21,60,41891.88,0.1
"2011","NE2","NE2","Total",29529,15414,14115,26604,2925,438,626.93,47.1
"2011","NE20","NE20","Total",11873,5774,6099,11741,132,277,13885.29,0.9
"2011","NE21","NE21","Total",17276,8311,8965,17116,160,100,1437.81,12
"2011","NE22","NE22","Total",17884,8673,9211,17698,186,134,1931.06,9.3
"2011","NE23","NE23","Total",39233,18913,20320,38846,387,293,3296.09,11.9
"2011","NE24","NE24","Total",38076,18537,19539,37700,376,184,2265.79,16.8
"2011","NE25","NE25","Total",29808,14363,15445,29621,187,296,2079.22,14.3
"2011","NE26","NE26","Total",19326,9450,9876,18973,353,279,1482.63,13
"2011","NE27","NE27","Total",12024,5751,6273,11981,43,65,1117.08,10.8
"2011","NE28","NE28","Total",44749,21626,23123,44465,284,201,1407.89,31.8
"2011","NE29","NE29","Total",35613,17277,18336,35237,376,195,1186.28,30
"2011","NE3","NE3","Total",53050,25975,27075,52339,711,802,1822.38,29.1
"2011","NE30","NE30","Total",22333,10726,11607,22183,150,243,553.83,40.3
"2011","NE31","NE31","Total",20130,9705,10425,19899,231,87,641.32,31.4
"2011","NE32","NE32","Total",25389,12257,13132,25132,257,125,960.01,26.4
"2011","NE33","NE33","Total",27069,13678,13391,26468,601,157,654.58,41.4
"2011","NE34","NE34","Total",52479,24875,27604,52170,309,266,1255.63,41.8
"2011","NE35","NE35","Total",6428,3152,3276,6428,0,41,270.91,23.7
"2011","NE36","NE36","Total",6854,3249,3605,6854,0,71,1579.01,4.3
"2011","NE37","NE37","Total",21056,10174,10882,20937,119,102,1529.88,13.8
"2011","NE38","NE38","Total",31101,15214,15887,31045,56,231,1377.14,22.6
"2011","NE39","NE39","Total",8575,4095,4480,8506,69,96,1944.74,4.4
"2011","NE4","NE4","Total",37437,19583,17854,36511,926,328,709.02,52.8
"2011","NE40","NE40","Total",15635,7495,8140,15502,133,149,1299.93,12
"2011","NE41","NE41","Total",2197,1065,1132,2164,33,52,1038.73,2.1
"2011","NE42","NE42","Total",12607,6068,6539,12479,128,146,1506.45,8.4
"2011","NE43","NE43","Total",4523,2197,2326,4415,108,117,5639.75,0.8
"2011","NE44","NE44","Total",966,448,518,925,41,25,756.8,1.3
"2011","NE45","NE45","Total",3672,1743,1929,3556,116,89,4149.37,0.9
"2011","NE46","NE46","Total",15537,7457,8080,15119,418,369,15225.05,1
"2011","NE47","NE47","Total",7917,3936,3981,7747,170,184,50634,0.2
"2011","NE48","NE48","Total",4294,2136,2158,4292,2,101,73314.78,0.1
"2011","NE49","NE49","Total",4344,2132,2212,4329,15,56,7287.85,0.6
"2011","NE5","NE5","Total",49103,23552,25551,48694,409,246,2022.95,24.3
"2011","NE6","NE6","Total",51027,25725,25302,50453,574,266,1060.95,48.1
"2011","NE61","NE61","Total",31269,15291,15978,30695,574,512,41593.89,0.8
"2011","NE62","NE62","Total",9636,4623,5013,9542,94,66,1167.39,8.3
"2011","NE63","NE63","Total",27789,13606,14183,27573,216,204,2358.86,11.8
"2011","NE64","NE64","Total",6308,3034,3274,6242,66,30,864.92,7.3
"2011","NE65","NE65","Total",20764,10620,10144,19548,1216,293,59291.64,0.4
"2011","NE66","NE66","Total",17590,8555,9035,17079,511,264,54665.91,0.3
"2011","NE67","NE67","Total",834,423,411,831,3,25,4986.69,0.2
"2011","NE68","NE68","Total",1959,953,1006,1952,7,16,790.33,2.5
"2011","NE69","NE69","Total",414,196,218,411,3,5,1445.21,0.3
"2011","NE7","NE7","Total",15468,7620,7848,14782,686,200,395.38,39.1
"2011","NE70","NE70","Total",1754,876,878,1751,3,33,8758.4,0.2
"2011","NE71","NE71","Total",2949,1410,1539,2927,22,30,26789.45,0.1
"2011","NE8","NE8","Total",33430,17348,16082,32244,1186,196,932.37,35.9
"2011","NE9","NE9","Total",37508,18108,19400,37026,482,239,1307.58,28.7
"2011","NG1","NG1","Total",12897,7227,5670,10836,2061,140,171.92,75
"2011","NG10","NG10","Total",46649,22965,23684,46277,372,395,1896.2,24.6
"2011","NG11","NG11","Total",37499,18260,19239,36566,933,399,6651.96,5.6
"2011","NG12","NG12","Total",33165,16197,16968,32761,404,545,14318.83,2.3
"2011","NG13","NG13","Total",21384,10782,10602,20478,906,348,16225.07,1.3
"2011","NG14","NG14","Total",19439,9868,9571,18434,1005,311,8932.38,2.2
"2011","NG15","NG15","Total",40698,19913,20785,40328,370,392,6438.06,6.3
"2011","NG16","NG16","Total",63551,31397,32154,63185,366,488,7128.4,8.9
"2011","NG17","NG17","Total",72786,35783,37003,72053,733,460,5760.02,12.6
"2011","NG18","NG18","Total",41526,20557,20969,40957,569,400,2755.11,15.1
"2011","NG19","NG19","Total",52276,25526,26750,51921,355,444,3309.16,15.8
"2011","NG2","NG2","Total",58609,29723,28886,57863,746,883,1876.83,31.2
"2011","NG20","NG20","Total",26190,12794,13396,25911,279,143,5435.42,4.8
"2011","NG21","NG21","Total",22181,10830,11351,21863,318,177,6072.92,3.7
"2011","NG22","NG22","Total",26293,12990,13303,26025,268,357,25741.12,1
"2011","NG23","NG23","Total",17245,8448,8797,17115,130,345,29609.86,0.6
"2011","NG24","NG24","Total",44805,21920,22885,44427,378,440,6380.37,7
"2011","NG25","NG25","Total",8913,4208,4705,8548,365,239,5087.61,1.8
"2011","NG3","NG3","Total",48188,24055,24133,46402,1786,467,1012.86,47.6
"2011","NG31","NG31","Total",44341,21493,22848,43878,463,562,5178.31,8.6
"2011","NG32","NG32","Total",12428,6082,6346,12379,49,234,25083.61,0.5
"2011","NG33","NG33","Total",9859,4883,4976,9858,1,214,26800.56,0.4
"2011","NG34","NG34","Total",41202,20045,21157,40728,474,602,40136.07,1
"2011","NG4","NG4","Total",40835,20113,20722,40536,299,294,2195.27,18.6
"2011","NG5","NG5","Total",87555,42590,44965,85936,1619,796,2116.35,41.4
"2011","NG6","NG6","Total",37485,18052,19433,36930,555,193,1994.52,18.8
"2011","NG7","NG7","Total",58012,31063,26949,51358,6654,535,1222.12,47.5
"2011","NG8","NG8","Total",63961,30909,33052,63240,721,638,2327.87,27.5
"2011","NG9","NG9","Total",73213,36136,37077,70871,2342,910,3300.75,22.2
"2011","NN1","NN1","Total",29834,15525,14309,29019,815,282,647.64,46.1
"2011","NN10","NN10","Total",38231,18848,19383,37817,414,348,3095.5,12.4
"2011","NN11","NN11","Total",37442,18485,18957,37177,265,534,20018.12,1.9
"2011","NN12","NN12","Total",23027,11502,11525,22850,177,536,20086.23,1.1
"2011","NN13","NN13","Total",18728,9333,9395,18479,249,390,15046.76,1.2
"2011","NN14","NN14","Total",43269,21315,21954,42986,283,636,26990.93,1.6
"2011","NN15","NN15","Total",33965,16599,17366,33685,280,477,2312.06,14.7
"2011","NN16","NN16","Total",30143,14966,15177,29664,479,287,1929.55,15.6
"2011","NN17","NN17","Total",26709,13191,13518,26479,230,238,9053.3,3
"2011","NN18","NN18","Total",32911,16176,16735,32844,67,297,2495.6,13.2
"2011","NN2","NN2","Total",38139,18540,19599,36174,1965,396,1484.89,25.7
"2011","NN29","NN29","Total",11520,5717,5803,11378,142,130,6358.71,1.8
"2011","NN3","NN3","Total",68586,33157,35429,68025,561,808,3238.73,21.2
"2011","NN4","NN4","Total",46714,22929,23785,46523,191,600,2904.01,16.1
"2011","NN5","NN5","Total",38050,18531,19519,37688,362,273,1698.42,22.4
"2011","NN6","NN6","Total",33324,16408,16916,33032,292,773,36913.63,0.9
"2011","NN7","NN7","Total",27299,13384,13915,27207,92,500,23153.94,1.2
"2011","NN8","NN8","Total",49047,24075,24972,48408,639,520,2817.06,17.4
"2011","NN9","NN9","Total",26277,13053,13224,25987,290,301,8717.34,3
"2011","NR1","NR1","Total",24791,12683,12108,24115,676,213,736.08,33.7
"2011","NR10","NR10","Total",22812,11598,11214,22013,799,248,16981.11,1.3
"2011","NR11","NR11","Total",17681,8564,9117,17530,151,302,22345.68,0.8
"2011","NR12","NR12","Total",20435,9906,10529,20039,396,218,19026.04,1.1
"2011","NR13","NR13","Total",26689,12966,13723,26330,359,353,18890.82,1.4
"2011","NR14","NR14","Total",23747,11543,12204,23491,256,419,19799.79,1.2
"2011","NR15","NR15","Total",15806,7746,8060,15668,138,230,14412.23,1.1
"2011","NR16","NR16","Total",11953,5870,6083,11786,167,187,16492.5,0.7
"2011","NR17","NR17","Total",15772,7815,7957,15605,167,190,11035.2,1.4
"2011","NR18","NR18","Total",17556,8526,9030,16771,785,290,9037.01,1.9
"2011","NR19","NR19","Total",20359,9904,10455,20129,230,206,6930.59,2.9
"2011","NR2","NR2","Total",25951,12583,13368,25770,181,363,510.41,50.8
"2011","NR20","NR20","Total",19331,9563,9768,18676,655,277,22706.18,0.9
"2011","NR21","NR21","Total",15815,7692,8123,15707,108,189,21504.09,0.7
"2011","NR22","NR22","Total",819,395,424,811,8,13,1897.51,0.4
"2011","NR23","NR23","Total",3009,1441,1568,2965,44,41,6693.54,0.4
"2011","NR24","NR24","Total",4462,2191,2271,4424,38,63,6233.42,0.7
"2011","NR25","NR25","Total",8878,4190,4688,8472,406,151,11819.38,0.8
"2011","NR26","NR26","Total",8299,3877,4422,8090,209,106,1120.2,7.4
"2011","NR27","NR27","Total",11733,5602,6131,11257,476,117,2347.17,5
"2011","NR28","NR28","Total",17532,8409,9123,17243,289,158,9653.41,1.8
"2011","NR29","NR29","Total",19924,9739,10185,19629,295,246,13753.75,1.4
"2011","NR3","NR3","Total",32971,16484,16487,32515,456,181,706.76,46.7
"2011","NR30","NR30","Total",30701,15152,15549,30251,450,156,2272.4,13.5
"2011","NR31","NR31","Total",49914,24499,25415,49546,368,372,4560.5,10.9
"2011","NR32","NR32","Total",38657,19066,19591,37850,807,333,4766.66,8.1
"2011","NR33","NR33","Total",39467,19106,20361,39003,464,367,2963.89,13.3
"2011","NR34","NR34","Total",22269,10811,11458,22129,140,277,20804.37,1.1
"2011","NR35","NR35","Total",10894,5303,5591,10674,220,150,10975.1,1
"2011","NR4","NR4","Total",21522,10160,11362,18181,3341,462,2151.26,10
"2011","NR5","NR5","Total",29288,14324,14964,29208,80,178,856.3,34.2
"2011","NR6","NR6","Total",23908,11712,12196,23724,184,195,1327.25,18
"2011","NR7","NR7","Total",31811,15457,16354,31470,341,303,1690.12,18.8
"2011","NR8","NR8","Total",20486,10019,10467,20103,383,234,2845.07,7.2
"2011","NR9","NR9","Total",16845,8172,8673,16624,221,319,16798.8,1
"2011","NW1","NW1","Total",60339,29974,30365,58707,1632,677,606.86,99.4
"2011","NW10","NW10","Total",91997,45360,46637,91784,213,840,1380.69,66.6
"2011","NW11","NW11","Total",32684,15755,16929,32318,366,830,556.99,58.7
"2011","NW2","NW2","Total",66968,33613,33355,66466,502,666,857.91,78.1
"2011","NW3","NW3","Total",51891,25002,26889,50863,1028,787,617.25,84.1
"2011","NW4","NW4","Total",31932,15823,16109,31610,322,485,507.89,62.9
"2011","NW5","NW5","Total",31125,14834,16291,30733,392,374,301.23,103.3
"2011","NW6","NW6","Total",63903,31189,32714,63672,231,627,503.2,127
"2011","NW7","NW7","Total",25670,12292,13378,25567,103,529,1338.1,19.2
"2011","NW8","NW8","Total",34353,16382,17971,34065,288,515,290.58,118.2
"2011","NW9","NW9","Total",60545,30030,30515,59881,664,738,1020.18,59.3
"2011","OL1","OL1","Total",21480,10574,10906,21255,225,160,794.91,27
"2011","OL10","OL10","Total",27794,13496,14298,27557,237,255,1697.39,16.4
"2011","OL11","OL11","Total",45812,22366,23446,45238,574,531,1768.37,25.9
"2011","OL12","OL12","Total",45667,22582,23085,45021,646,533,4567.66,10
"2011","OL13","OL13","Total",15099,7433,7666,14985,114,138,2359.53,6.4
"2011","OL14","OL14","Total",15481,7466,8015,15277,204,196,5172.14,3
"2011","OL15","OL15","Total",14461,7051,7410,14264,197,123,2897.03,5
"2011","OL16","OL16","Total",37825,18729,19096,37589,236,310,2826.52,13.4
"2011","OL2","OL2","Total",42349,20523,21826,42050,299,473,2105.06,20.1
"2011","OL3","OL3","Total",14997,7415,7582,14969,28,319,6627.51,2.3
"2011","OL4","OL4","Total",45060,22079,22981,44708,352,478,1935.05,23.3
"2011","OL5","OL5","Total",10921,5345,5576,10837,84,102,865.89,12.6
"2011","OL6","OL6","Total",28793,14429,14364,28501,292,242,1094.52,26.3
"2011","OL7","OL7","Total",16763,8282,8481,16613,150,127,523.82,32
"2011","OL8","OL8","Total",39046,19090,19956,38668,378,217,1013.77,38.5
"2011","OL9","OL9","Total",41285,20482,20803,40978,307,321,1078.29,38.3
"2011","OX1","OX1","Total",25623,13686,11937,15532,10091,521,2447.05,10.5
"2011","OX10","OX10","Total",26363,13091,13272,25372,991,485,11474.14,2.3
"2011","OX11","OX11","Total",33102,16343,16759,32930,172,512,7773.62,4.3
"2011","OX12","OX12","Total",25264,12445,12819,24969,295,500,17539.72,1.4
"2011","OX13","OX13","Total",13459,6996,6463,12519,940,341,8549.87,1.6
"2011","OX14","OX14","Total",44510,22057,22453,43448,1062,865,7660.61,5.8
"2011","OX15","OX15","Total",18099,8839,9260,17664,435,534,19587.65,0.9
"2011","OX16","OX16","Total",46853,22818,24035,46325,528,436,2105.84,22.2
"2011","OX17","OX17","Total",16975,8243,8732,16769,206,355,18397.94,0.9
"2011","OX18","OX18","Total",25301,12891,12410,23876,1425,451,15912.76,1.6
"2011","OX2","OX2","Total",39695,19582,20113,35280,4415,1077,4220.17,9.4
"2011","OX20","OX20","Total",4734,2212,2522,4680,54,86,4515.12,1
"2011","OX25","OX25","Total",9619,5172,4447,8632,987,170,9757.08,1
"2011","OX26","OX26","Total",33494,16649,16845,33051,443,320,3742.18,9
"2011","OX27","OX27","Total",6517,3170,3347,6414,103,138,8824.72,0.7
"2011","OX28","OX28","Total",27522,13340,14182,27303,219,428,922.32,29.8
"2011","OX29","OX29","Total",23060,11291,11769,22779,281,519,17640.8,1.3
"2011","OX3","OX3","Total",43437,20755,22682,40553,2884,687,3767.92,11.5
"2011","OX33","OX33","Total",7623,3743,3880,7500,123,191,5489.38,1.4
"2011","OX39","OX39","Total",6881,3351,3530,6851,30,120,3292.61,2.1
"2011","OX4","OX4","Total",61972,30556,31416,60265,1707,602,1749.2,35.4
"2011","OX44","OX44","Total",8307,4090,4217,8279,28,165,8843.66,0.9
"2011","OX49","OX49","Total",4324,2055,2269,4279,45,122,6508.41,0.7
"2011","OX5","OX5","Total",23419,11545,11874,23055,364,418,11010.44,2.1
"2011","OX7","OX7","Total",22852,11068,11784,22463,389,531,29049.37,0.8
"2011","OX9","OX9","Total",13822,6708,7114,13746,76,317,5272.83,2.6
"2011","PE1","PE1","Total",49173,24726,24447,48791,382,420,1665.39,29.5
"2011","PE10","PE10","Total",21906,10634,11272,21606,300,429,17113.76,1.3
"2011","PE11","PE11","Total",43230,21068,22162,42800,430,457,23289.51,1.9
"2011","PE12","PE12","Total",39782,19469,20313,39375,407,386,44092.07,0.9
"2011","PE13","PE13","Total",34893,17125,17768,34497,396,281,14041.73,2.5
"2011","PE14","PE14","Total",20803,10249,10554,20585,218,201,25481.26,0.8
"2011","PE15","PE15","Total",29915,14752,15163,29206,709,243,17803.02,1.7
"2011","PE16","PE16","Total",10453,5163,5290,10414,39,100,6117.96,1.7
"2011","PE19","PE19","Total",43968,21885,22083,43649,319,578,19466.14,2.3
"2011","PE2","PE2","Total",44540,21870,22670,44320,220,434,2773.34,16.1
"2011","PE20","PE20","Total",13986,6836,7150,13911,75,156,18153.73,0.8
"2011","PE21","PE21","Total",42787,20635,22152,42314,473,405,4830.58,8.9
"2011","PE22","PE22","Total",16919,8559,8360,16544,375,219,35590.54,0.5
"2011","PE23","PE23","Total",8507,4130,4377,8298,209,102,15899.83,0.5
"2011","PE24","PE24","Total",11830,5779,6051,11724,106,93,14923.87,0.8
"2011","PE25","PE25","Total",21638,10396,11242,20668,970,159,2150.14,10.1
"2011","PE26","PE26","Total",11945,5945,6000,11826,119,163,10278.54,1.2
"2011","PE27","PE27","Total",20015,9926,10089,19973,42,304,2472.74,8.1
"2011","PE28","PE28","Total",47574,24178,23396,45800,1774,901,48850.4,1
"2011","PE29","PE29","Total",29782,14675,15107,29531,251,337,2897.09,10.3
"2011","PE3","PE3","Total",28897,14171,14726,28390,507,395,1199.88,24.1
"2011","PE30","PE30","Total",43989,21507,22482,43455,534,440,4429.66,9.9
"2011","PE31","PE31","Total",20003,9482,10521,19770,233,268,34298.57,0.6
"2011","PE32","PE32","Total",15294,7479,7815,15212,82,243,33196.7,0.5
"2011","PE33","PE33","Total",15945,8103,7842,15054,891,236,21314.45,0.7
"2011","PE34","PE34","Total",14384,7079,7305,14344,40,148,16202.03,0.9
"2011","PE36","PE36","Total",6529,3066,3463,6337,192,118,7153.7,0.9
"2011","PE37","PE37","Total",10224,4828,5396,9955,269,86,10287.91,1
"2011","PE38","PE38","Total",14809,7189,7620,14686,123,163,12235.48,1.2
"2011","PE4","PE4","Total",28361,13837,14524,28263,98,321,1090.55,26
"2011","PE5","PE5","Total",1589,775,814,1589,0,55,2871.48,0.6
"2011","PE6","PE6","Total",35553,17301,18252,35399,154,592,28192.06,1.3
"2011","PE7","PE7","Total",42311,20747,21564,42093,218,474,18041.18,2.3
"2011","PE8","PE8","Total",17500,8887,8613,16012,1488,442,24692.77,0.7
"2011","PE9","PE9","Total",31189,14968,16221,30693,496,634,20250.15,1.5
"2011","PL1","PL1","Total",22698,12011,10687,21913,785,131,532.92,42.6
"2011","PL10","PL10","Total",3656,1771,1885,3656,0,43,1796,2
"2011","PL11","PL11","Total",10359,4980,5379,10337,22,101,4487.57,2.3
"2011","PL12","PL12","Total",21787,10643,11144,21758,29,284,10680.44,2
"2011","PL13","PL13","Total",9438,4588,4850,9382,56,98,8689,1.1
"2011","PL14","PL14","Total",22966,11118,11848,22964,2,277,26402.85,0.9
"2011","PL15","PL15","Total",19907,9683,10224,19404,503,258,36957.67,0.5
"2011","PL16","PL16","Total",1753,878,875,1753,0,34,4470.85,0.4
"2011","PL17","PL17","Total",10022,5005,5017,9942,80,118,8334.08,1.2
"2011","PL18","PL18","Total",4810,2331,2479,4810,0,104,1474.83,3.3
"2011","PL19","PL19","Total",16423,7791,8632,15884,539,333,18510.74,0.9
"2011","PL2","PL2","Total",31458,15625,15833,31139,319,212,673.95,46.7
"2011","PL20","PL20","Total",12081,6032,6049,11367,714,224,32499.28,0.4
"2011","PL21","PL21","Total",17389,8400,8989,17206,183,355,11670.55,1.5
"2011","PL22","PL22","Total",3695,1752,1943,3568,127,37,6827.87,0.5
"2011","PL23","PL23","Total",3519,1672,1847,3430,89,68,3135.18,1.1
"2011","PL24","PL24","Total",10156,4876,5280,9854,302,73,1663.03,6.1
"2011","PL25","PL25","Total",25551,12317,13234,24893,658,249,2228.92,11.5
"2011","PL26","PL26","Total",26673,13076,13597,26376,297,222,17634.09,1.5
"2011","PL27","PL27","Total",12227,5766,6461,11849,378,178,13426.7,0.9
"2011","PL28","PL28","Total",4434,2114,2320,4324,110,39,2954.75,1.5
"2011","PL29","PL29","Total",1029,505,524,972,57,10,1529.6,0.7
"2011","PL3","PL3","Total",30951,15006,15945,30495,456,346,698.68,44.3
"2011","PL30","PL30","Total",10557,5159,5398,10356,201,125,32043.27,0.3
"2011","PL31","PL31","Total",14736,7142,7594,14475,261,157,1340.45,11
"2011","PL32","PL32","Total",4326,2091,2235,4257,69,41,9111.28,0.5
"2011","PL33","PL33","Total",1647,803,844,1647,0,16,272.02,6.1
"2011","PL34","PL34","Total",1782,859,923,1712,70,11,1972.99,0.9
"2011","PL35","PL35","Total",940,455,485,935,5,9,2103.32,0.4
"2011","PL4","PL4","Total",36464,19131,17333,34227,2237,272,507.11,71.9
"2011","PL5","PL5","Total",42916,20765,22151,42674,242,229,1287.19,33.3
"2011","PL6","PL6","Total",41200,19911,21289,40322,878,307,3940.95,10.5
"2011","PL7","PL7","Total",31474,15175,16299,31034,440,280,7445.48,4.2
"2011","PL8","PL8","Total",5734,2751,2983,5681,53,140,6253.92,0.9
"2011","PL9","PL9","Total",27961,13424,14537,27767,194,308,3279.55,8.5
"2011","PO1","PO1","Total",28841,14920,13921,26606,2235,256,466.62,61.8
"2011","PO10","PO10","Total",18360,8897,9463,17644,716,274,2344.78,7.8
"2011","PO11","PO11","Total",17379,8390,8989,16932,447,160,1589.47,10.9
"2011","PO12","PO12","Total",47846,23781,24065,47169,677,464,1314.06,36.4
"2011","PO13","PO13","Total",34776,16955,17821,34597,179,282,1218.03,28.6
"2011","PO14","PO14","Total",32177,15571,16606,31796,381,472,2413.39,13.3
"2011","PO15","PO15","Total",22884,11276,11608,22765,119,260,1753.76,13
"2011","PO16","PO16","Total",32656,16017,16639,32224,432,366,1281.79,25.5
"2011","PO17","PO17","Total",6527,3257,3270,6204,323,106,4391.99,1.5
"2011","PO18","PO18","Total",13017,6261,6756,12706,311,322,18974.78,0.7
"2011","PO19","PO19","Total",30245,14236,16009,29406,839,432,1675.61,18.1
"2011","PO2","PO2","Total",42043,20678,21365,41913,130,174,552.41,76.1
"2011","PO20","PO20","Total",32121,15300,16821,31462,659,459,9938.08,3.2
"2011","PO21","PO21","Total",40302,19254,21048,38442,1860,301,1971.88,20.4
"2011","PO22","PO22","Total",28350,13476,14874,28113,237,313,2410.19,11.8
"2011","PO3","PO3","Total",19286,9573,9713,19064,222,160,568.57,33.9
"2011","PO30","PO30","Total",30309,15520,14789,28279,2030,319,14829.6,2
"2011","PO31","PO31","Total",14398,6980,7418,14229,169,183,1245.09,11.6
"2011","PO32","PO32","Total",8101,3902,4199,7976,125,60,1131.56,7.2
"2011","PO33","PO33","Total",31007,14887,16120,30198,809,334,4930.36,6.3
"2011","PO34","PO34","Total",2083,985,1098,2077,6,38,278.22,7.5
"2011","PO35","PO35","Total",3688,1696,1992,3472,216,59,912.78,4
"2011","PO36","PO36","Total",16958,8145,8813,16579,379,159,3696,4.6
"2011","PO37","PO37","Total",9072,4414,4658,8683,389,118,772.19,11.7
"2011","PO38","PO38","Total",12547,6097,6450,12357,190,135,6117.12,2.1
"2011","PO39","PO39","Total",2645,1263,1382,2473,172,25,529.21,5
"2011","PO4","PO4","Total",44069,22298,21771,43089,980,427,627.69,70.2
"2011","PO40","PO40","Total",5436,2557,2879,5371,65,54,1311.13,4.1
"2011","PO41","PO41","Total",2021,978,1043,2019,2,35,2262.84,0.9
"2011","PO5","PO5","Total",29923,15759,14164,28785,1138,262,287.48,104.1
"2011","PO6","PO6","Total",40563,19810,20753,40264,299,327,1528.5,26.5
"2011","PO7","PO7","Total",40172,19599,20573,39861,311,463,6890.13,5.8
"2011","PO8","PO8","Total",33840,16506,17334,33671,169,373,4374.21,7.7
"2011","PO9","PO9","Total",48689,23632,25057,48365,324,400,4427.41,11
"2011","PR1","PR1","Total",71549,36407,35142,67249,4300,695,2562.7,27.9
"2011","PR2","PR2","Total",79208,38912,40296,77639,1569,917,4050.15,19.6
"2011","PR25","PR25","Total",30781,14976,15805,30570,211,300,1535.46,20
"2011","PR26","PR26","Total",15588,8666,6922,13541,2047,173,3810.66,4.1
"2011","PR3","PR3","Total",37971,18533,19438,37224,747,662,36221.26,1
"2011","PR4","PR4","Total",57595,28469,29126,56620,975,859,21757.13,2.6
"2011","PR5","PR5","Total",41203,20214,20989,40755,448,389,4408.71,9.3
"2011","PR6","PR6","Total",34691,17050,17641,34382,309,438,7804.18,4.4
"2011","PR7","PR7","Total",55452,27385,28067,55022,430,599,6241.56,8.9
"2011","PR8","PR8","Total",53618,25697,27921,52602,1016,730,3417.95,15.7
"2011","PR9","PR9","Total",42900,20482,22418,41862,1038,450,4966.54,8.6
"2011","RG1","RG1","Total",42332,22171,20161,40901,1431,420,878.75,48.2
"2011","RG10","RG10","Total",18256,8984,9272,18087,169,441,6074.29,3
"2011","RG12","RG12","Total",51883,25585,26298,51740,143,607,1489.81,34.8
"2011","RG14","RG14","Total",37838,18773,19065,37310,528,601,3221.89,11.7
"2011","RG17","RG17","Total",15094,7442,7652,14902,192,319,17607.77,0.9
"2011","RG18","RG18","Total",19056,9310,9746,18271,785,352,5229.61,3.6
"2011","RG19","RG19","Total",17656,8866,8790,17490,166,272,4217.85,4.2
"2011","RG2","RG2","Total",37616,18768,18848,36265,1351,360,2400.83,15.7
"2011","RG20","RG20","Total",18884,9376,9508,18594,290,629,27927.98,0.7
"2011","RG21","RG21","Total",26927,13519,13408,26658,269,285,978.1,27.5
"2011","RG22","RG22","Total",41762,20490,21272,41698,64,526,1104.4,37.8
"2011","RG23","RG23","Total",12269,6050,6219,12175,94,209,3362.17,3.6
"2011","RG24","RG24","Total",31256,15411,15845,30988,268,427,3756.68,8.3
"2011","RG25","RG25","Total",8705,4360,4345,8643,62,227,15473.63,0.6
"2011","RG26","RG26","Total",22133,11085,11048,21979,154,397,8689.99,2.5
"2011","RG27","RG27","Total",21026,10383,10643,20729,297,589,12690.69,1.7
"2011","RG28","RG28","Total",5786,2800,2986,5729,57,162,7445.29,0.8
"2011","RG29","RG29","Total",7143,3805,3338,6164,979,189,4717.91,1.5
"2011","RG30","RG30","Total",44131,21739,22392,43659,472,450,2493.05,17.7
"2011","RG31","RG31","Total",27276,13410,13866,27229,47,521,998.8,27.3
"2011","RG4","RG4","Total",39134,19081,20053,38670,464,793,5052.65,7.7
"2011","RG40","RG40","Total",26480,13021,13459,26006,474,647,3949.05,6.7
"2011","RG41","RG41","Total",28226,13844,14382,27878,348,676,2252.65,12.5
"2011","RG42","RG42","Total",26041,12776,13265,25904,137,473,2983.21,8.7
"2011","RG45","RG45","Total",14565,7367,7198,13449,1116,416,1987.45,7.3
"2011","RG5","RG5","Total",25235,12500,12735,25194,41,391,800.07,31.5
"2011","RG6","RG6","Total",37937,18983,18954,35859,2078,850,1127.72,33.6
"2011","RG7","RG7","Total",31944,16032,15912,30961,983,692,19829.29,1.6
"2011","RG8","RG8","Total",18932,9378,9554,18302,630,615,11517.59,1.6
"2011","RG9","RG9","Total",23154,11266,11888,22313,841,685,16063.21,1.4
"2011","RH1","RH1","Total",46125,22720,23405,45419,706,631,5730.28,8
"2011","RH10","RH10","Total",65219,32554,32665,64540,679,819,5726.98,11.4
"2011","RH11","RH11","Total",55816,27433,28383,55178,638,525,4798.17,11.6
"2011","RH12","RH12","Total",43776,21206,22570,43082,694,787,10770.22,4.1
"2011","RH13","RH13","Total",38108,18781,19327,36882,1226,832,16126.76,2.4
"2011","RH14","RH14","Total",14087,6920,7167,14027,60,340,10910.49,1.3
"2011","RH15","RH15","Total",31545,15317,16228,30985,560,403,2576.14,12.2
"2011","RH16","RH16","Total",33550,16323,17227,33129,421,533,2180.73,15.4
"2011","RH17","RH17","Total",19263,9477,9786,18550,713,528,16627.59,1.2
"2011","RH18","RH18","Total",4453,2125,2328,4431,22,136,1994.11,2.2
"2011","RH19","RH19","Total",33479,16462,17017,32817,662,667,6986.93,4.8
"2011","RH2","RH2","Total",26229,12685,13544,25421,808,519,3990.79,6.6
"2011","RH20","RH20","Total",24968,12080,12888,24566,402,561,16255.94,1.5
"2011","RH3","RH3","Total",4366,2109,2257,4281,85,116,1869.37,2.3
"2011","RH4","RH4","Total",15479,7454,8025,15165,314,309,1974.79,7.8
"2011","RH5","RH5","Total",16545,8183,8362,15990,555,457,15076.25,1.1
"2011","RH6","RH6","Total",29317,14516,14801,28947,370,343,4587.32,6.4
"2011","RH7","RH7","Total",9222,4473,4749,8746,476,159,6045.43,1.5
"2011","RH8","RH8","Total",15546,7496,8050,15232,314,404,4466.51,3.5
"2011","RH9","RH9","Total",5443,2569,2874,5309,134,71,2951.01,1.8
"2011","RM1","RM1","Total",19610,9526,10084,19445,165,205,383.36,51.2
"2011","RM10","RM10","Total",38181,18311,19870,37892,289,336,796.31,47.9
"2011","RM11","RM11","Total",31777,15265,16512,31598,179,449,880.59,36.1
"2011","RM12","RM12","Total",34240,16499,17741,34139,101,341,809.7,42.3
"2011","RM13","RM13","Total",28916,14041,14875,28839,77,252,2215.63,13.1
"2011","RM14","RM14","Total",27030,12978,14052,26785,245,390,5713.55,4.7
"2011","RM15","RM15","Total",27446,13579,13867,27375,71,170,2699.68,10.2
"2011","RM16","RM16","Total",41136,20176,20960,40929,207,394,2507.2,16.4
"2011","RM17","RM17","Total",27405,13781,13624,27218,187,221,622.83,44
"2011","RM18","RM18","Total",16664,8095,8569,16598,66,109,2490.23,6.7
"2011","RM19","RM19","Total",6527,3265,3262,6526,1,41,479.87,13.6
"2011","RM2","RM2","Total",13184,6444,6740,13125,59,176,395.73,33.3
"2011","RM20","RM20","Total",4877,2517,2360,4877,0,26,661.69,7.4
"2011","RM3","RM3","Total",40387,19331,21056,40057,330,289,1321.94,30.6
"2011","RM4","RM4","Total",4191,2048,2143,4169,22,41,3435.17,1.2
"2011","RM5","RM5","Total",18344,8720,9624,18161,183,109,627.75,29.2
"2011","RM6","RM6","Total",32702,15750,16952,32528,174,347,1184.86,27.6
"2011","RM7","RM7","Total",28931,13899,15032,28486,445,230,868.42,33.3
"2011","RM8","RM8","Total",39073,18595,20478,38931,142,365,542.6,72
"2011","RM9","RM9","Total",36203,17364,18839,36074,129,299,534.11,67.8
"2011","S1","S1","Total",10651,5242,5409,7987,2664,130,142.63,74.7
"2011","S10","S10","Total",47408,23385,24023,44598,2810,762,4009.43,11.8
"2011","S11","S11","Total",34383,17040,17343,34156,227,740,1092.75,31.5
"2011","S12","S12","Total",34342,16663,17679,34000,342,192,2147.22,16
"2011","S13","S13","Total",30670,14882,15788,30398,272,130,1255.18,24.4
"2011","S14","S14","Total",9665,4633,5032,9605,60,42,229.29,42.2
"2011","S17","S17","Total",15586,7460,8126,15474,112,302,1503.88,10.4
"2011","S18","S18","Total",24729,12056,12673,24589,140,308,5783.21,4.3
"2011","S2","S2","Total",44529,22459,22070,42384,2145,247,1101.33,40.4
"2011","S20","S20","Total",31382,15402,15980,31245,137,224,1369.64,22.9
"2011","S21","S21","Total",21030,10350,10680,20794,236,153,3925.96,5.4
"2011","S25","S25","Total",21101,10378,10723,20964,137,229,3209.03,6.6
"2011","S26","S26","Total",25888,12640,13248,25809,79,235,4633.86,5.6
"2011","S3","S3","Total",19330,10475,8855,16509,2821,133,330.82,58.4
"2011","S32","S32","Total",5697,2755,2942,5605,92,148,6650.93,0.9
"2011","S33","S33","Total",4961,2431,2530,4935,26,95,17641.1,0.3
"2011","S35","S35","Total",41401,20166,21235,41157,244,383,6530.52,6.3
"2011","S36","S36","Total",27347,13517,13830,27183,164,313,15101.29,1.8
"2011","S4","S4","Total",14465,7236,7229,14246,219,76,344.63,42
"2011","S40","S40","Total",35398,17329,18069,35153,245,456,1127.54,31.4
"2011","S41","S41","Total",36402,17909,18493,35893,509,372,2507.86,14.5
"2011","S42","S42","Total",28228,13923,14305,28045,183,356,7037.41,4
"2011","S43","S43","Total",40349,19778,20571,39938,411,303,3966.09,10.2
"2011","S44","S44","Total",21700,10586,11114,21538,162,158,7186.07,3
"2011","S45","S45","Total",13622,6717,6905,13499,123,125,6360.09,2.1
"2011","S5","S5","Total",59868,28947,30921,59457,411,270,1381.84,43.3
"2011","S6","S6","Total",58252,28751,29501,57945,307,437,10782.44,5.4
"2011","S60","S60","Total",37295,18325,18970,36973,322,380,2971.97,12.5
"2011","S61","S61","Total",35820,17756,18064,35578,242,247,2078.57,17.2
"2011","S62","S62","Total",19976,9694,10282,19777,199,131,3252.62,6.1
"2011","S63","S63","Total",38096,18606,19490,37742,354,230,2771.86,13.7
"2011","S64","S64","Total",30696,15098,15598,30451,245,204,1619.9,18.9
"2011","S65","S65","Total",35575,17480,18095,35240,335,223,2764.37,12.9
"2011","S66","S66","Total",46183,22603,23580,45852,331,436,7192.95,6.4
"2011","S7","S7","Total",17436,8922,8514,17283,153,323,390.26,44.7
"2011","S70","S70","Total",38839,19279,19560,38472,367,243,2325.84,16.7
"2011","S71","S71","Total",44892,22070,22822,44613,279,269,2640.54,17
"2011","S72","S72","Total",25354,12433,12921,25106,248,167,3914.23,6.5
"2011","S73","S73","Total",27014,13241,13773,26795,219,164,2063.87,13.1
"2011","S74","S74","Total",17710,8620,9090,17610,100,105,1207.8,14.7
"2011","S75","S75","Total",43598,21316,22282,43278,320,443,7728.75,5.6
"2011","S8","S8","Total",46174,22570,23604,45759,415,442,1415.98,32.6
"2011","S80","S80","Total",30032,14762,15270,29534,498,219,11520.29,2.6
"2011","S81","S81","Total",37344,18231,19113,37008,336,386,9699.96,3.8
"2011","S9","S9","Total",28089,14003,14086,27942,147,126,1871.8,15
"2011","SE1","SE1","Total",67037,34645,32392,63309,3728,553,559.97,119.7
"2011","SE10","SE10","Total",23987,11944,12043,23604,383,183,514.16,46.7
"2011","SE11","SE11","Total",21974,11289,10685,21476,498,241,194.78,112.8
"2011","SE12","SE12","Total",27143,13123,14020,27094,49,304,482.03,56.3
"2011","SE13","SE13","Total",42278,21311,20967,41857,421,387,435.54,97.1
"2011","SE14","SE14","Total",24679,12421,12258,23666,1013,275,265.56,92.9
"2011","SE15","SE15","Total",64359,31446,32913,63887,472,670,559.49,115
"2011","SE16","SE16","Total",44957,22288,22669,44757,200,366,432.71,103.9
"2011","SE17","SE17","Total",33591,16661,16930,33410,181,311,201.39,166.8
"2011","SE18","SE18","Total",77384,39267,38117,76773,611,725,1105.65,70
"2011","SE19","SE19","Total",27650,13388,14262,27413,237,299,446.5,61.9
"2011","SE2","SE2","Total",27104,13038,14066,27000,104,294,506.84,53.5
"2011","SE20","SE20","Total",22881,11093,11788,22710,171,210,281.3,81.3
"2011","SE21","SE21","Total",15259,7395,7864,15070,189,364,433.91,35.2
"2011","SE22","SE22","Total",29738,14139,15599,29602,136,340,363.91,81.7
"2011","SE23","SE23","Total",33489,16584,16905,33383,106,377,421.17,79.5
"2011","SE24","SE24","Total",18914,9218,9696,18873,41,280,267.88,70.6
"2011","SE25","SE25","Total",34686,16618,18068,34576,110,368,488.2,71
"2011","SE26","SE26","Total",28378,13714,14664,28041,337,317,388.58,73
"2011","SE27","SE27","Total",21836,10481,11355,21646,190,273,246.45,88.6
"2011","SE28","SE28","Total",29488,14827,14661,28469,1019,331,509.38,57.9
"2011","SE3","SE3","Total",31790,15520,16270,31467,323,444,678.96,46.8
"2011","SE4","SE4","Total",28723,13838,14885,28448,275,274,314.74,91.3
"2011","SE5","SE5","Total",46256,22731,23525,45279,977,588,405.54,114.1
"2011","SE6","SE6","Total",53271,25720,27551,52835,436,583,725.19,73.5
"2011","SE7","SE7","Total",21139,10276,10863,20946,193,210,378.06,55.9
"2011","SE8","SE8","Total",27859,13782,14077,27130,729,315,277.16,100.5
"2011","SE9","SE9","Total",62852,30305,32547,61593,1259,599,1507.52,41.7
"2011","SG1","SG1","Total",51250,25558,25692,50904,346,525,1741.76,29.4
"2011","SG10","SG10","Total",2087,987,1100,1914,173,58,1816.09,1.1
"2011","SG11","SG11","Total",7969,3981,3988,7826,143,150,8022.62,1
"2011","SG12","SG12","Total",30067,14806,15261,29699,368,489,8958.25,3.4
"2011","SG13","SG13","Total",16643,8273,8370,16173,470,407,4557.8,3.7
"2011","SG14","SG14","Total",18798,9128,9670,18731,67,328,4638.16,4.1
"2011","SG15","SG15","Total",5584,2765,2819,5522,62,60,948.68,5.9
"2011","SG16","SG16","Total",6110,3070,3040,5953,157,90,1703.11,3.6
"2011","SG17","SG17","Total",12203,6034,6169,11868,335,202,2557.13,4.8
"2011","SG18","SG18","Total",24128,11939,12189,23981,147,271,9527.88,2.5
"2011","SG19","SG19","Total",24097,11976,12121,24017,80,308,13516.1,1.8
"2011","SG2","SG2","Total",42112,20703,21409,41906,206,496,5069.62,8.3
"2011","SG3","SG3","Total",7068,3458,3610,6979,89,138,2143.63,3.3
"2011","SG4","SG4","Total",29212,14283,14929,28892,320,592,11245.95,2.6
"2011","SG5","SG5","Total",31407,15463,15944,31179,228,416,7812.95,4
"2011","SG6","SG6","Total",33249,16071,17178,32897,352,482,2011.19,16.5
"2011","SG7","SG7","Total",13276,6565,6711,13085,191,230,6349.33,2.1
"2011","SG8","SG8","Total",38277,18937,19340,37795,482,726,26614.18,1.4
"2011","SG9","SG9","Total",9374,4661,4713,9321,53,219,11641.57,0.8
"2011","SK1","SK1","Total",11550,5863,5687,11425,125,66,397.61,29
"2011","SK10","SK10","Total",39804,19467,20337,39303,501,884,10439.3,3.8
"2011","SK11","SK11","Total",36547,17885,18662,36190,357,521,18711.71,2
"2011","SK12","SK12","Total",19072,9270,9802,18863,209,393,3649.24,5.2
"2011","SK13","SK13","Total",33090,16207,16883,32851,239,445,12602.67,2.6
"2011","SK14","SK14","Total",46233,22616,23617,45884,349,354,2671.55,17.3
"2011","SK15","SK15","Total",27424,13574,13850,27192,232,257,2512.05,10.9
"2011","SK16","SK16","Total",19645,9687,9958,19460,185,115,564.51,34.8
"2011","SK17","SK17","Total",32207,15956,16251,31620,587,483,35335.63,0.9
"2011","SK2","SK2","Total",28909,14270,14639,28651,258,312,834.39,34.6
"2011","SK22","SK22","Total",12230,6060,6170,12135,95,176,5305.38,2.3
"2011","SK23","SK23","Total",17125,8459,8666,16993,132,271,6814.67,2.5
"2011","SK3","SK3","Total",28387,13805,14582,28090,297,217,590.83,48
"2011","SK4","SK4","Total",34804,17142,17662,34358,446,526,930.4,37.4
"2011","SK5","SK5","Total",29154,14252,14902,29074,80,183,725.23,40.2
"2011","SK6","SK6","Total",50813,24694,26119,50277,536,598,4644.8,10.9
"2011","SK7","SK7","Total",40454,19599,20855,40136,318,854,2383.82,17
"2011","SK8","SK8","Total",58346,28373,29973,58070,276,951,2046.03,28.5
"2011","SK9","SK9","Total",38001,18431,19570,37150,851,866,4661.18,8.2
"2011","SL0","SL0","Total",11119,5522,5597,11072,47,193,2009.25,5.5
"2011","SL1","SL1","Total",70804,35596,35208,70463,341,724,2422.2,29.2
"2011","SL2","SL2","Total",53290,26219,27071,52867,423,681,3919.69,13.6
"2011","SL3","SL3","Total",45163,22355,22808,44984,179,663,3409.61,13.2
"2011","SL4","SL4","Total",43347,21828,21519,41595,1752,784,6986.01,6.2
"2011","SL5","SL5","Total",23870,11319,12551,22466,1404,687,3795.93,6.3
"2011","SL6","SL6","Total",77837,38208,39629,77084,753,1579,10795.8,7.2
"2011","SL7","SL7","Total",20946,10208,10738,20826,120,509,5035.04,4.2
"2011","SL8","SL8","Total",6448,3121,3327,6384,64,154,619.79,10.4
"2011","SL9","SL9","Total",20783,9942,10841,20299,484,719,2698.64,7.7
"2011","SM1","SM1","Total",38062,18564,19498,37754,308,422,585.56,65
"2011","SM2","SM2","Total",27688,13680,14008,26261,1427,484,774.7,35.7
"2011","SM3","SM3","Total",21018,10274,10744,20943,75,341,396.79,53
"2011","SM4","SM4","Total",36841,18277,18564,36727,114,392,677.35,54.4
"2011","SM5","SM5","Total",38682,18645,20037,38541,141,504,1134.68,34.1
"2011","SM6","SM6","Total",36494,17557,18937,36242,252,497,752.61,48.5
"2011","SM7","SM7","Total",18263,8686,9577,17681,582,372,1160.31,15.7
"2011","SN1","SN1","Total",29665,15815,13850,29173,492,281,698.24,42.5
"2011","SN10","SN10","Total",31544,15459,16085,30530,1014,646,22432.07,1.4
"2011","SN11","SN11","Total",22358,10816,11542,21881,477,310,10295.38,2.2
"2011","SN12","SN12","Total",25211,12362,12849,24892,319,320,6278.58,4
"2011","SN13","SN13","Total",16529,7961,8568,16320,209,335,4546.82,3.6
"2011","SN14","SN14","Total",28083,14015,14068,27439,644,572,19276.28,1.5
"2011","SN15","SN15","Total",35109,17587,17522,34084,1025,703,17558.23,2
"2011","SN16","SN16","Total",13831,6853,6978,13709,122,362,15379.43,0.9
"2011","SN2","SN2","Total",41148,20507,20641,41104,44,257,1294.14,31.8
"2011","SN25","SN25","Total",35205,17551,17654,35152,53,273,903.24,39
"2011","SN26","SN26","Total",1827,900,927,1782,45,25,1518.36,1.2
"2011","SN3","SN3","Total",51117,25045,26072,50797,320,476,2491.72,20.5
"2011","SN4","SN4","Total",27628,13545,14083,27207,421,548,19322.45,1.4
"2011","SN5","SN5","Total",33001,16403,16598,32845,156,526,4657.83,7.1
"2011","SN6","SN6","Total",21161,10425,10736,20884,277,520,17109.02,1.2
"2011","SN7","SN7","Total",13484,6632,6852,13357,127,335,14957.78,0.9
"2011","SN8","SN8","Total",24018,11749,12269,22970,1048,684,43013.58,0.6
"2011","SN9","SN9","Total",8130,3936,4194,8067,63,239,14839.38,0.5
"2011","SO14","SO14","Total",27451,15047,12404,24701,2750,240,497.7,55.2
"2011","SO15","SO15","Total",42112,21540,20572,41084,1028,418,945.05,44.6
"2011","SO16","SO16","Total",65918,32462,33456,63622,2296,606,3650.91,18.1
"2011","SO17","SO17","Total",19322,10115,9207,18960,362,206,318.47,60.7
"2011","SO18","SO18","Total",36990,18244,18746,35270,1720,324,799.72,46.3
"2011","SO19","SO19","Total",56342,27560,28782,56007,335,293,1127.68,50
"2011","SO20","SO20","Total",8081,4047,4034,7840,241,282,14799.67,0.5
"2011","SO21","SO21","Total",19557,9631,9926,19069,488,608,26563.32,0.7
"2011","SO22","SO22","Total",28611,13684,14927,26615,1996,707,1389.68,20.6
"2011","SO23","SO23","Total",22364,10897,11467,20566,1798,511,2510.24,8.9
"2011","SO24","SO24","Total",11324,5479,5845,11193,131,388,17825.27,0.6
"2011","SO30","SO30","Total",32278,15657,16621,31812,466,348,3018.55,10.7
"2011","SO31","SO31","Total",44733,22006,22727,44109,624,607,3544.27,12.6
"2011","SO32","SO32","Total",19752,9552,10200,19550,202,513,13330.99,1.5
"2011","SO40","SO40","Total",41855,20598,21257,41191,664,448,5254.4,8
"2011","SO41","SO41","Total",31388,14760,16628,30889,499,474,7223.56,4.3
"2011","SO42","SO42","Total",5273,2566,2707,5062,211,121,16626.78,0.3
"2011","SO43","SO43","Total",4391,2128,2263,4191,200,78,8399.07,0.5
"2011","SO45","SO45","Total",34987,16970,18017,34853,134,324,4992.68,7
"2011","SO50","SO50","Total",46390,23116,23274,46196,194,408,3276.96,14.2
"2011","SO51","SO51","Total",26578,12780,13798,25947,631,539,12722.95,2.1
"2011","SO52","SO52","Total",7037,3416,3621,6987,50,66,810.75,8.7
"2011","SO53","SO53","Total",32459,15774,16685,32249,210,588,1072,30.3
"2011","SP1","SP1","Total",21491,10130,11361,20618,873,458,1403.3,15.3
"2011","SP10","SP10","Total",40652,19851,20801,40171,481,451,1878.34,21.6
"2011","SP11","SP11","Total",23446,11745,11701,22487,959,610,31514.57,0.7
"2011","SP2","SP2","Total",29309,14160,15149,28902,407,453,6168.06,4.8
"2011","SP3","SP3","Total",11303,5480,5823,11192,111,366,28056.4,0.4
"2011","SP4","SP4","Total",31111,15960,15151,29324,1787,603,20766.63,1.5
"2011","SP5","SP5","Total",22361,10826,11535,22068,293,631,39636.59,0.6
"2011","SP6","SP6","Total",14047,6863,7184,13840,207,300,15409.99,0.9
"2011","SP7","SP7","Total",13556,6583,6973,12697,859,332,12517.97,1.1
"2011","SP8","SP8","Total",14570,7131,7439,14430,140,259,7510.2,1.9
"2011","SP9","SP9","Total",10678,6395,4283,8330,2348,161,2865.13,3.7
"2011","SR1","SR1","Total",5414,2918,2496,4785,629,42,212.63,25.5
"2011","SR2","SR2","Total",32933,16525,16408,32473,460,222,1138.42,28.9
"2011","SR3","SR3","Total",39412,18838,20574,39228,184,199,1795.46,22
"2011","SR4","SR4","Total",41580,20019,21561,40376,1204,228,1554.68,26.7
"2011","SR5","SR5","Total",34792,16632,18160,34387,405,133,1129.09,30.8
"2011","SR6","SR6","Total",30086,14534,15552,29805,281,232,1478.61,20.3
"2011","SR7","SR7","Total",31165,15237,15928,30769,396,136,3450.84,9
"2011","SR8","SR8","Total",35444,17253,18191,35098,346,213,2800.43,12.7
"2011","SS0","SS0","Total",41454,20701,20753,40457,997,428,640.44,64.7
"2011","SS1","SS1","Total",25953,12790,13163,25529,424,348,547.64,47.4
"2011","SS11","SS11","Total",16738,8180,8558,16472,266,134,2751.57,6.1
"2011","SS12","SS12","Total",18029,8797,9232,17913,116,142,1397.46,12.9
"2011","SS13","SS13","Total",22124,10822,11302,21992,132,133,1804.78,12.3
"2011","SS14","SS14","Total",24915,11783,13132,24560,355,140,875.07,28.5
"2011","SS15","SS15","Total",30263,14554,15709,30123,140,207,1238.84,24.4
"2011","SS16","SS16","Total",29490,14468,15022,29327,163,264,1323.66,22.3
"2011","SS17","SS17","Total",32823,16003,16820,32722,101,320,4492.72,7.3
"2011","SS2","SS2","Total",36455,17820,18635,36234,221,277,1142.68,31.9
"2011","SS3","SS3","Total",28604,13854,14750,28420,184,317,6004.75,4.8
"2011","SS4","SS4","Total",20993,10216,10777,20844,149,205,7349.6,2.9
"2011","SS5","SS5","Total",21540,10584,10956,21536,4,248,1942.29,11.1
"2011","SS6","SS6","Total",31792,15535,16257,31451,341,325,1196.34,26.6
"2011","SS7","SS7","Total",49256,23964,25292,48838,418,533,2635.23,18.7
"2011","SS8","SS8","Total",38170,18664,19506,37962,208,218,1827.88,20.9
"2011","SS9","SS9","Total",50078,24259,25819,49678,400,598,1300.01,38.5
"2011","ST1","ST1","Total",29860,15458,14402,29533,327,207,988.54,30.2
"2011","ST10","ST10","Total",25598,12756,12842,25305,293,333,18813.5,1.4
"2011","ST11","ST11","Total",9995,4939,5056,9875,120,122,3784.76,2.6
"2011","ST12","ST12","Total",3809,1841,1968,3702,107,39,2224.37,1.7
"2011","ST13","ST13","Total",27981,13670,14311,27542,439,319,14903.74,1.9
"2011","ST14","ST14","Total",20545,10604,9941,19237,1308,298,9915.82,2.1
"2011","ST15","ST15","Total",21412,10442,10970,21076,336,328,8260.65,2.6
"2011","ST16","ST16","Total",30955,16257,14698,29851,1104,349,1332.74,23.2
"2011","ST17","ST17","Total",39718,19491,20227,39490,228,530,7276.33,5.5
"2011","ST18","ST18","Total",16223,8347,7876,15076,1147,292,19546.91,0.8
"2011","ST19","ST19","Total",14751,7177,7574,14683,68,205,9929.66,1.5
"2011","ST2","ST2","Total",34192,16563,17629,33961,231,175,1586.91,21.5
"2011","ST20","ST20","Total",6711,3323,3388,6698,13,151,8153.65,0.8
"2011","ST21","ST21","Total",5674,2690,2984,5404,270,121,9772.67,0.6
"2011","ST3","ST3","Total",67670,33361,34309,67234,436,408,3025.3,22.4
"2011","ST4","ST4","Total",57197,29056,28141,55869,1328,474,2470.54,23.2
"2011","ST5","ST5","Total",82400,40707,41693,78498,3902,834,9505.86,8.7
"2011","ST6","ST6","Total",64454,31697,32757,63819,635,334,3109.55,20.7
"2011","ST7","ST7","Total",52883,26101,26782,52536,347,555,6796.34,7.8
"2011","ST8","ST8","Total",20375,9932,10443,20188,187,175,2796.32,7.3
"2011","ST9","ST9","Total",11665,5725,5940,11458,207,163,4814.68,2.4
"2011","SW10","SW10","Total",18478,8978,9500,18360,118,349,132.15,139.8
"2011","SW11","SW11","Total",71717,34862,36855,71389,328,862,600.53,119.4
"2011","SW12","SW12","Total",31586,15262,16324,31303,283,477,302.25,104.5
"2011","SW13","SW13","Total",16190,7796,8394,16095,95,433,389.79,41.5
"2011","SW14","SW14","Total",16830,8115,8715,16674,156,390,658.51,25.6
"2011","SW15","SW15","Total",60456,28410,32046,58394,2062,1073,983.34,61.5
"2011","SW16","SW16","Total",80927,39668,41259,79785,1142,1024,934.6,86.6
"2011","SW17","SW17","Total",64215,31164,33051,63304,911,737,619.7,103.6
"2011","SW18","SW18","Total",58992,29394,29598,57661,1331,861,674.5,87.5
"2011","SW19","SW19","Total",77676,38223,39453,76776,900,1258,1520.81,51.1
"2011","SW1A","SW1A","Total",246,150,96,245,1,3,20.93,11.8
"2011","SW1E","SW1E","Total",919,569,350,589,330,19,36.03,25.5
"2011","SW1H","SW1H","Total",734,408,326,734,0,14,34.2,21.5
"2011","SW1P","SW1P","Total",13508,7052,6456,12809,699,212,113.3,119.2
"2011","SW1V","SW1V","Total",22574,11181,11393,22404,170,310,101.44,222.5
"2011","SW1W","SW1W","Total",8557,4276,4281,8469,88,278,99.96,85.6
"2011","SW1X","SW1X","Total",6026,3122,2904,6026,0,145,86.43,69.7
"2011","SW1Y","SW1Y","Total",550,325,225,542,8,5,36.57,15
"2011","SW2","SW2","Total",54331,26851,27480,53627,704,481,387.55,140.2
"2011","SW20","SW20","Total",28275,13769,14506,28009,266,554,586.2,48.2
"2011","SW3","SW3","Total",22170,10818,11352,21652,518,603,189.68,116.9
"2011","SW4","SW4","Total",39586,19791,19795,39360,226,465,340.57,116.2
"2011","SW5","SW5","Total",15493,8079,7414,15276,217,200,79.7,194.4
"2011","SW6","SW6","Total",65149,31294,33855,64721,428,1079,507.14,128.5
"2011","SW7","SW7","Total",19852,10528,9324,17739,2113,391,396.17,50.1
"2011","SW8","SW8","Total",36408,18537,17871,36222,186,363,355.49,102.4
"2011","SW9","SW9","Total",43399,21965,21434,43200,199,413,290.76,149.3
"2011","SY1","SY1","Total",26536,13310,13226,25981,555,208,1664.58,15.9
"2011","SY10","SY10","Total",14663,7234,7429,14319,344,237,45245.95,0.3
"2011","SY11","SY11","Total",27014,13148,13866,26316,698,313,8912.96,3
"2011","SY12","SY12","Total",8250,4096,4154,7961,289,153,12841.06,0.6
"2011","SY13","SY13","Total",19549,9700,9849,19321,228,281,24481.83,0.8
"2011","SY14","SY14","Total",5644,2760,2884,5584,60,139,11144.45,0.5
"2011","SY15","SY15","Total",5199,2571,2628,5145,54,91,14214.88,0.4
"2011","SY16","SY16","Total",16232,8058,8174,16087,145,215,25318.97,0.6
"2011","SY17","SY17","Total",3553,1788,1765,3544,9,59,15013.3,0.2
"2011","SY18","SY18","Total",4648,2339,2309,4598,50,74,23581.69,0.2
"2011","SY19","SY19","Total",1169,601,568,1161,8,18,17712.22,0.1
"2011","SY2","SY2","Total",17535,8563,8972,17306,229,249,869.35,20.2
"2011","SY20","SY20","Total",6921,3401,3520,6858,63,106,49867.34,0.1
"2011","SY21","SY21","Total",16250,8038,8212,16013,237,250,44148.94,0.4
"2011","SY22","SY22","Total",9534,4745,4789,9443,91,151,26910.22,0.4
"2011","SY23","SY23","Total",30858,15619,15239,27189,3669,492,49140.64,0.6
"2011","SY24","SY24","Total",4663,2285,2378,4628,35,79,9459.02,0.5
"2011","SY25","SY25","Total",4343,2122,2221,4328,15,80,43434.09,0.1
"2011","SY3","SY3","Total",33785,16550,17235,32611,1174,751,3985.16,8.5
"2011","SY4","SY4","Total",24540,12182,12358,23608,932,481,36625.69,0.7
"2011","SY5","SY5","Total",21288,10595,10693,20736,552,438,47948.91,0.4
"2011","SY6","SY6","Total",6554,3145,3409,6411,143,122,11909.71,0.6
"2011","SY7","SY7","Total",11884,5969,5915,11747,137,271,46992.71,0.3
"2011","SY8","SY8","Total",18633,9095,9538,18435,198,312,24805.46,0.8
"2011","SY9","SY9","Total",2895,1417,1478,2769,126,44,10838.4,0.3
"2011","TA1","TA1","Total",39473,18831,20642,38212,1261,552,1652.81,23.9
"2011","TA10","TA10","Total",9270,4495,4775,9119,151,179,10747.76,0.9
"2011","TA11","TA11","Total",9166,4401,4765,9070,96,199,9337.5,1
"2011","TA12","TA12","Total",6353,3079,3274,6306,47,95,3515.96,1.8
"2011","TA13","TA13","Total",3973,1897,2076,3940,33,69,1950.82,2
"2011","TA14","TA14","Total",2986,1459,1527,2986,0,49,1157.87,2.6
"2011","TA15","TA15","Total",831,413,418,829,2,11,593.46,1.4
"2011","TA16","TA16","Total",1979,964,1015,1950,29,21,1096.56,1.8
"2011","TA17","TA17","Total",442,207,235,442,0,6,859.97,0.5
"2011","TA18","TA18","Total",10039,4845,5194,9980,59,137,4918.51,2
"2011","TA19","TA19","Total",11688,5613,6075,11574,114,158,8145.75,1.4
"2011","TA2","TA2","Total",26524,13095,13429,25338,1186,380,4921.74,5.4
"2011","TA20","TA20","Total",20332,10033,10299,20182,150,233,13854.27,1.5
"2011","TA21","TA21","Total",18155,8774,9381,17660,495,284,10369.43,1.8
"2011","TA22","TA22","Total",2619,1257,1362,2600,19,39,11216.47,0.2
"2011","TA23","TA23","Total",5681,2765,2916,5656,25,74,6068.17,0.9
"2011","TA24","TA24","Total",18650,8782,9868,17391,1259,180,36575.24,0.5
"2011","TA3","TA3","Total",14412,6994,7418,14202,210,305,19467.86,0.7
"2011","TA4","TA4","Total",18849,9115,9734,18584,265,384,26703.55,0.7
"2011","TA5","TA5","Total",10155,4998,5157,9978,177,174,18325.92,0.6
"2011","TA6","TA6","Total",46320,22815,23505,45865,455,387,4495.46,10.3
"2011","TA7","TA7","Total",14982,7327,7655,14858,124,253,16734.62,0.9
"2011","TA8","TA8","Total",16938,8077,8861,16490,448,134,2136.76,7.9
"2011","TA9","TA9","Total",12380,6106,6274,12211,169,142,6991.25,1.8
"2011","TD12","TD12","Total",1163,584,579,1148,15,37,11544.99,0.1
"2011","TD15","TD15","Total",17161,8262,8899,16793,368,212,27890.46,0.6
"2011","TF1","TF1","Total",37144,18320,18824,36832,312,377,1547.85,24
"2011","TF10","TF10","Total",18398,9187,9211,17374,1024,364,11077.86,1.7
"2011","TF11","TF11","Total",9907,4940,4967,9849,58,170,14005.75,0.7
"2011","TF12","TF12","Total",5609,2756,2853,5583,26,71,3272.34,1.7
"2011","TF13","TF13","Total",3696,1764,1932,3631,65,71,7543.22,0.5
"2011","TF2","TF2","Total",38813,19163,19650,38482,331,387,3137.58,12.4
"2011","TF3","TF3","Total",23954,11993,11961,23926,28,201,1231.17,19.5
"2011","TF4","TF4","Total",18198,9022,9176,18029,169,142,1101.14,16.5
"2011","TF5","TF5","Total",5346,2684,2662,5342,4,74,336.09,15.9
"2011","TF6","TF6","Total",4997,2501,2496,4837,160,93,11650.03,0.4
"2011","TF7","TF7","Total",17631,8583,9048,17530,101,127,884.09,19.9
"2011","TF8","TF8","Total",2903,1483,1420,2829,74,59,1396.12,2.1
"2011","TF9","TF9","Total",25465,12956,12509,24455,1010,361,23832.99,1.1
"2011","TN1","TN1","Total",11247,5796,5451,11149,98,160,149.96,75
"2011","TN10","TN10","Total",16283,7763,8520,16222,61,256,747.34,21.8
"2011","TN11","TN11","Total",13872,6814,7058,13685,187,410,10591.79,1.3
"2011","TN12","TN12","Total",29475,14556,14919,29260,215,551,13941.39,2.1
"2011","TN13","TN13","Total",24993,12146,12847,24241,752,657,2075.86,12
"2011","TN14","TN14","Total",14970,7342,7628,14937,33,301,7566.34,2
"2011","TN15","TN15","Total",24338,11877,12461,24092,246,504,11678.8,2.1
"2011","TN16","TN16","Total",19293,9465,9828,19223,70,329,5933.81,3.3
"2011","TN17","TN17","Total",14720,7022,7698,13615,1105,489,14546.65,1
"2011","TN18","TN18","Total",6612,3268,3344,6549,63,175,4845.41,1.4
"2011","TN19","TN19","Total",5000,2477,2523,4880,120,108,5387.09,0.9
"2011","TN2","TN2","Total",28428,13782,14646,27828,600,558,2898.58,9.8
"2011","TN20","TN20","Total",3718,1798,1920,3620,98,117,4715.93,0.8
"2011","TN21","TN21","Total",15983,7737,8246,15726,257,299,9087.57,1.8
"2011","TN22","TN22","Total",26183,12726,13457,25820,363,541,13612.71,1.9
"2011","TN23","TN23","Total",39896,19561,20335,39717,179,363,2606.99,15.3
"2011","TN24","TN24","Total",31619,15292,16327,31218,401,311,1550.75,20.4
"2011","TN25","TN25","Total",15556,7565,7991,15434,122,263,17650.64,0.9
"2011","TN26","TN26","Total",11182,5435,5747,11045,137,184,14527.41,0.8
"2011","TN27","TN27","Total",12404,6004,6400,12348,56,237,12807.54,1
"2011","TN28","TN28","Total",8455,4151,4304,8236,219,74,722.69,11.7
"2011","TN29","TN29","Total",13757,6802,6955,13566,191,109,17563.7,0.8
"2011","TN3","TN3","Total",11722,5713,6009,11580,142,361,10654.52,1.1
"2011","TN30","TN30","Total",9307,4350,4957,9209,98,158,7003.02,1.3
"2011","TN31","TN31","Total",13542,6581,6961,13372,170,166,13626.86,1
"2011","TN32","TN32","Total",5238,2577,2661,4850,388,161,8338.27,0.6
"2011","TN33","TN33","Total",12745,6142,6603,12477,268,273,11658.12,1.1
"2011","TN34","TN34","Total",29691,14439,15252,29281,410,264,893.18,33.2
"2011","TN35","TN35","Total",17207,8289,8918,16958,249,176,4793.09,3.6
"2011","TN36","TN36","Total",2303,1102,1201,2300,3,24,2026.43,1.1
"2011","TN37","TN37","Total",20561,10191,10370,20200,361,162,676.22,30.4
"2011","TN38","TN38","Total",29035,14085,14950,28200,835,240,976.82,29.7
"2011","TN39","TN39","Total",25768,11947,13821,25379,389,270,2504.71,10.3
"2011","TN4","TN4","Total",32239,15860,16379,31871,368,643,1618.75,19.9
"2011","TN40","TN40","Total",17422,8061,9361,16545,877,142,688.26,25.3
"2011","TN5","TN5","Total",8756,4225,4531,8623,133,291,7265.98,1.2
"2011","TN6","TN6","Total",24430,11991,12439,23769,661,518,6108.21,4
"2011","TN7","TN7","Total",2151,1081,1070,2117,34,66,3852.33,0.6
"2011","TN8","TN8","Total",12680,6113,6567,12561,119,251,7912.1,1.6
"2011","TN9","TN9","Total",18035,9106,8929,17494,541,352,1064.88,16.9
"2011","TQ1","TQ1","Total",31701,15437,16264,30582,1119,306,1170.83,27.1
"2011","TQ10","TQ10","Total",4029,1903,2126,3949,80,70,7928.21,0.5
"2011","TQ11","TQ11","Total",4133,2011,2122,4017,116,49,4052.97,1
"2011","TQ12","TQ12","Total",52994,26002,26992,51612,1382,697,12110.66,4.4
"2011","TQ13","TQ13","Total",23134,11180,11954,22837,297,434,36446.25,0.6
"2011","TQ14","TQ14","Total",19461,9242,10219,18856,605,233,2560.6,7.6
"2011","TQ2","TQ2","Total",33544,16287,17257,32838,706,377,1507.6,22.2
"2011","TQ3","TQ3","Total",30368,14582,15786,29871,497,280,1928.53,15.7
"2011","TQ4","TQ4","Total",18647,8839,9808,18198,449,167,1195.66,15.6
"2011","TQ5","TQ5","Total",19304,9246,10058,19015,289,172,1992.96,9.7
"2011","TQ6","TQ6","Total",8267,4131,4136,7975,292,98,5135.67,1.6
"2011","TQ7","TQ7","Total",16492,7859,8633,16287,205,288,20420.63,0.8
"2011","TQ8","TQ8","Total",2071,993,1078,2020,51,46,1284.86,1.6
"2011","TQ9","TQ9","Total",17259,8163,9096,17113,146,296,17881.89,1
"2011","TR1","TR1","Total",20534,9734,10800,20401,133,324,1410.29,14.6
"2011","TR10","TR10","Total",11258,5527,5731,10105,1153,101,3098.44,3.6
"2011","TR11","TR11","Total",28826,13767,15059,28771,55,333,6468.72,4.5
"2011","TR12","TR12","Total",9584,5053,4531,8817,767,127,16264.63,0.6
"2011","TR13","TR13","Total",19823,9612,10211,19774,49,257,9404.03,2.1
"2011","TR14","TR14","Total",24632,11931,12701,24527,105,181,6034.01,4.1
"2011","TR15","TR15","Total",20094,9822,10272,19876,218,122,1889.51,10.6
"2011","TR16","TR16","Total",14160,6900,7260,14123,37,117,5351.19,2.6
"2011","TR17","TR17","Total",1447,670,777,1390,57,9,299.53,4.8
"2011","TR18","TR18","Total",19872,9399,10473,19436,436,200,923.01,21.5
"2011","TR19","TR19","Total",9033,4423,4610,8826,207,114,9584.18,0.9
"2011","TR2","TR2","Total",9465,4506,4959,9429,36,172,16821.51,0.6
"2011","TR20","TR20","Total",9293,4447,4846,9078,215,149,10491.5,0.9
"2011","TR21","TR21","Total",1723,858,865,1647,76,52,656.73,2.6
"2011","TR22","TR22","Total",169,85,84,168,1,13,322.48,0.5
"2011","TR24","TR24","Total",175,93,82,175,0,10,382.71,0.5
"2011","TR25","TR25","Total",136,66,70,133,3,4,275.55,0.5
"2011","TR26","TR26","Total",11642,5487,6155,11206,436,137,3510.36,3.3
"2011","TR27","TR27","Total",14766,7160,7606,14448,318,131,6631.76,2.2
"2011","TR3","TR3","Total",12399,5963,6436,12382,17,215,6326.76,2
"2011","TR4","TR4","Total",11047,5359,5688,11047,0,147,12687.29,0.9
"2011","TR5","TR5","Total",3884,1834,2050,3884,0,67,1943.28,2
"2011","TR6","TR6","Total",3516,1701,1815,3516,0,41,953.12,3.7
"2011","TR7","TR7","Total",20189,9892,10297,19624,565,210,1056.49,19.1
"2011","TR8","TR8","Total",7973,3909,4064,7732,241,104,13063.47,0.6
"2011","TR9","TR9","Total",8224,4026,4198,8139,85,81,4811.08,1.7
"2011","TS1","TS1","Total",17202,9390,7812,16135,1067,147,524.16,32.8
"2011","TS10","TS10","Total",37073,18015,19058,36721,352,317,2942.36,12.6
"2011","TS11","TS11","Total",11945,5793,6152,11906,39,112,3529.51,3.4
"2011","TS12","TS12","Total",22514,11033,11481,22215,299,191,6424.37,3.5
"2011","TS13","TS13","Total",10369,5168,5201,10277,92,60,9062.4,1.1
"2011","TS14","TS14","Total",17627,8542,9085,17373,254,234,5503.15,3.2
"2011","TS15","TS15","Total",12802,6460,6342,12474,328,262,6560.04,2
"2011","TS16","TS16","Total",10449,5055,5394,10343,106,183,2217.62,4.7
"2011","TS17","TS17","Total",45119,22149,22970,44310,809,490,1585.5,28.5
"2011","TS18","TS18","Total",24877,12852,12025,23312,1565,260,1547.49,16.1
"2011","TS19","TS19","Total",37115,17779,19336,36843,272,248,1066.72,34.8
"2011","TS2","TS2","Total",773,380,393,773,0,5,2250.84,0.3
"2011","TS20","TS20","Total",20737,10193,10544,20520,217,185,612.25,33.9
"2011","TS21","TS21","Total",12670,6219,6451,12528,142,176,17339.72,0.7
"2011","TS22","TS22","Total",8506,4163,4343,8468,38,136,2993.87,2.8
"2011","TS23","TS23","Total",30225,14577,15648,29955,270,249,1434.32,21.1
"2011","TS24","TS24","Total",21840,10773,11067,21636,204,126,874.57,25
"2011","TS25","TS25","Total",38827,18631,20196,38398,429,308,3479.02,11.2
"2011","TS26","TS26","Total",25450,12490,12960,25184,266,279,821.17,31
"2011","TS27","TS27","Total",12327,5973,6354,12279,48,104,5485.34,2.2
"2011","TS28","TS28","Total",5277,2545,2732,5257,20,41,1435.1,3.7
"2011","TS29","TS29","Total",6266,3061,3205,6194,72,39,1226.65,5.1
"2011","TS3","TS3","Total",29653,13888,15765,29483,170,87,704.32,42.1
"2011","TS4","TS4","Total",17229,8409,8820,16812,417,86,666.24,25.9
"2011","TS5","TS5","Total",39717,19351,20366,39478,239,356,1334.99,29.8
"2011","TS6","TS6","Total",30350,14595,15755,30128,222,157,1525.89,19.9
"2011","TS7","TS7","Total",21787,10551,11236,21698,89,249,1356.54,16.1
"2011","TS8","TS8","Total",21011,10077,10934,20737,274,172,2445.96,8.6
"2011","TS9","TS9","Total",12737,6151,6586,12735,2,253,16674.37,0.8
"2011","TW1","TW1","Total",25392,12557,12835,24380,1012,494,405.03,62.7
"2011","TW10","TW10","Total",19152,9283,9869,18756,396,358,1139.43,16.8
"2011","TW11","TW11","Total",23410,11301,12109,23214,196,492,670.46,34.9
"2011","TW12","TW12","Total",23010,11031,11979,22737,273,494,631.11,36.5
"2011","TW13","TW13","Total",36258,18018,18240,36073,185,254,1024.04,35.4
"2011","TW14","TW14","Total",28023,13836,14187,27853,170,217,854.73,32.8
"2011","TW15","TW15","Total",27462,13483,13979,27124,338,283,657.54,41.8
"2011","TW16","TW16","Total",20143,9915,10228,19968,175,236,753.2,26.7
"2011","TW17","TW17","Total",14242,6980,7262,14196,46,176,1076.69,13.2
"2011","TW18","TW18","Total",26173,12897,13276,26019,154,287,1503.62,17.4
"2011","TW19","TW19","Total",16019,7986,8033,15960,59,146,1385.64,11.6
"2011","TW2","TW2","Total",30645,15045,15600,30441,204,464,615.31,49.8
"2011","TW20","TW20","Total",24845,11856,12989,22298,2547,429,2084.65,11.9
"2011","TW3","TW3","Total",40168,20854,19314,40020,148,429,486.9,82.5
"2011","TW4","TW4","Total",27229,13879,13350,26998,231,257,564.35,48.2
"2011","TW5","TW5","Total",29463,14978,14485,29378,85,413,626.69,47
"2011","TW7","TW7","Total",37540,18571,18969,37368,172,445,1000.99,37.5
"2011","TW8","TW8","Total",19667,9635,10032,18791,876,219,397.54,49.5
"2011","TW9","TW9","Total",21631,10601,11030,21515,116,408,620.08,34.9
"2011","UB1","UB1","Total",40374,20795,19579,39230,1144,399,529.69,76.2
"2011","UB10","UB10","Total",33494,16429,17065,33364,130,586,1307.94,25.6
"2011","UB2","UB2","Total",32239,16614,15625,31992,247,345,635.9,50.7
"2011","UB3","UB3","Total",48133,24233,23900,47800,333,444,1409.92,34.1
"2011","UB4","UB4","Total",39616,19784,19832,39497,119,348,739.38,53.6
"2011","UB5","UB5","Total",45955,22458,23497,45931,24,465,879.79,52.2
"2011","UB6","UB6","Total",51364,26008,25356,51102,262,589,1098.72,46.7
"2011","UB7","UB7","Total",29652,14836,14816,29151,501,222,2593.19,11.4
"2011","UB8","UB8","Total",36604,18683,17921,32134,4470,426,974.95,37.5
"2011","UB9","UB9","Total",14538,7053,7485,14231,307,183,3124.61,4.7
"2011","W10","W10","Total",34202,16336,17866,33994,208,332,261.88,130.6
"2011","W11","W11","Total",31499,15169,16330,31245,254,557,202.2,155.8
"2011","W12","W12","Total",48949,23891,25058,48252,697,484,521.57,93.8
"2011","W13","W13","Total",32411,16030,16381,32191,220,518,384.18,84.4
"2011","W14","W14","Total",37480,18391,19089,37315,165,451,246.55,152
"2011","W1B","W1B","Total",508,260,248,508,0,9,7.58,67
"2011","W1D","W1D","Total",1544,1004,540,1465,79,10,34.99,44.1
"2011","W1F","W1F","Total",1510,906,604,1506,4,14,19.45,77.6
"2011","W1G","W1G","Total",2931,1555,1376,2871,60,28,36.98,79.3
"2011","W1H","W1H","Total",6289,3371,2918,6080,209,123,41.75,150.6
"2011","W1J","W1J","Total",1528,887,641,1526,2,13,52.69,29
"2011","W1K","W1K","Total",3015,1655,1360,2990,25,47,50.48,59.7
"2011","W1S","W1S","Total",151,97,54,151,0,0,10.29,14.7
"2011","W1T","W1T","Total",4060,2338,1722,3277,783,33,35.49,114.4
"2011","W1U","W1U","Total",5651,3016,2635,5503,148,84,54.7,103.3
"2011","W1W","W1W","Total",4434,2289,2145,3807,627,67,30.5,145.4
"2011","W2","W2","Total",48372,25112,23260,47055,1317,682,291.03,166.2
"2011","W3","W3","Total",52419,26202,26217,52008,411,535,755,69.4
"2011","W4","W4","Total",44018,21672,22346,43857,161,753,660.45,66.6
"2011","W5","W5","Total",49943,24755,25188,48703,1240,749,860.7,58
"2011","W6","W6","Total",35728,17587,18141,35177,551,472,307.01,116.4
"2011","W7","W7","Total",28959,13995,14964,28794,165,378,426.74,67.9
"2011","W8","W8","Total",20536,10070,10466,19953,583,559,178.72,114.9
"2011","W9","W9","Total",37569,18384,19185,37333,236,435,187.28,200.6
"2011","WA1","WA1","Total",21533,10772,10761,21200,333,196,1528.9,14.1
"2011","WA10","WA10","Total",38648,19149,19499,38322,326,368,1870.62,20.7
"2011","WA11","WA11","Total",40516,19765,20751,40369,147,350,4606.8,8.8
"2011","WA12","WA12","Total",22033,10846,11187,21911,122,179,1178.84,18.7
"2011","WA13","WA13","Total",12830,6280,6550,12741,89,295,2727.5,4.7
"2011","WA14","WA14","Total",27690,13605,14085,27315,375,535,2358.15,11.7
"2011","WA15","WA15","Total",42664,20775,21889,42517,147,1045,3101.73,13.8
"2011","WA16","WA16","Total",23544,11379,12165,23162,382,481,14581.46,1.6
"2011","WA2","WA2","Total",40792,20027,20765,40279,513,298,1807.47,22.6
"2011","WA3","WA3","Total",47757,24007,23750,46485,1272,564,6521.94,7.3
"2011","WA4","WA4","Total",46673,23149,23524,46023,650,813,7239.32,6.4
"2011","WA5","WA5","Total",58500,28828,29672,57863,637,693,4192.42,14
"2011","WA6","WA6","Total",18925,9154,9771,18717,208,390,7184.63,2.6
"2011","WA7","WA7","Total",63271,30948,32323,62902,369,481,4456.01,14.2
"2011","WA8","WA8","Total",61934,30171,31763,61431,503,514,4558.71,13.6
"2011","WA9","WA9","Total",48870,23952,24918,48436,434,304,2301.39,21.2
"2011","WC1A","WC1A","Total",545,290,255,545,0,1,2.33,233.9
"2011","WC1B","WC1B","Total",1667,823,844,1480,187,23,34.13,48.8
"2011","WC1E","WC1E","Total",2282,1205,1077,1724,558,27,25.41,89.8
"2011","WC1H","WC1H","Total",8328,4056,4272,6646,1682,64,42.06,198
"2011","WC1N","WC1N","Total",7295,3758,3537,6546,749,56,43.91,166.1
"2011","WC1R","WC1R","Total",630,333,297,629,1,14,10.89,57.9
"2011","WC1V","WC1V","Total",960,506,454,604,356,8,24.01,40
"2011","WC1X","WC1X","Total",7953,3943,4010,6846,1107,77,42.68,186.3
"2011","WC2B","WC2B","Total",1907,1092,815,1714,193,8,16.17,117.9
"2011","WC2E","WC2E","Total",905,501,404,832,73,6,46.77,19.4
"2011","WC2H","WC2H","Total",2491,1350,1141,2462,29,18,21.1,118.1
"2011","WC2N","WC2N","Total",1032,572,460,784,248,7,47.47,21.7
"2011","WD17","WD17","Total",15787,7922,7865,15483,304,312,584.47,27
"2011","WD18","WD18","Total",24334,12252,12082,24100,234,283,558.07,43.6
"2011","WD19","WD19","Total",27375,13212,14163,27215,160,415,963.54,28.4
"2011","WD23","WD23","Total",25640,12329,13311,25186,454,578,1412.51,18.2
"2011","WD24","WD24","Total",21615,10868,10747,21543,72,225,410.79,52.6
"2011","WD25","WD25","Total",27808,13466,14342,27594,214,318,1762.57,15.8
"2011","WD3","WD3","Total",40666,19618,21048,40182,484,989,5392.04,7.5
"2011","WD4","WD4","Total",11252,5522,5730,11201,51,204,2824.74,4
"2011","WD5","WD5","Total",11497,5641,5856,11396,101,172,522.8,22
"2011","WD6","WD6","Total",37545,18310,19235,37023,522,505,1982.51,18.9
"2011","WD7","WD7","Total",12469,6091,6378,12294,175,362,2193.37,5.7
"2011","WF1","WF1","Total",33897,17091,16806,33512,385,281,1959.81,17.3
"2011","WF10","WF10","Total",45457,22291,23166,45040,417,312,3423.99,13.3
"2011","WF11","WF11","Total",16984,8331,8653,16861,123,88,4113.25,4.1
"2011","WF12","WF12","Total",33976,16808,17168,33658,318,229,2131.81,15.9
"2011","WF13","WF13","Total",27462,13782,13680,27143,319,149,698.78,39.3
"2011","WF14","WF14","Total",19563,9458,10105,19372,191,222,1353.09,14.5
"2011","WF15","WF15","Total",17697,8674,9023,17591,106,140,1178.25,15
"2011","WF16","WF16","Total",12623,6216,6407,12496,127,62,311.56,40.5
"2011","WF17","WF17","Total",43719,21764,21955,43487,232,257,1562.72,28
"2011","WF2","WF2","Total",51023,25144,25879,49951,1072,558,3214.97,15.9
"2011","WF3","WF3","Total",32594,15902,16692,32334,260,330,4089.4,8
"2011","WF4","WF4","Total",43308,20943,22365,42816,492,425,9223.8,4.7
"2011","WF5","WF5","Total",21231,10369,10862,21149,82,199,1422.51,14.9
"2011","WF6","WF6","Total",21317,10478,10839,21161,156,167,1267.1,16.8
"2011","WF7","WF7","Total",20185,9763,10422,19949,236,158,2120.04,9.5
"2011","WF8","WF8","Total",32376,15802,16574,32152,224,346,5168.72,6.3
"2011","WF9","WF9","Total",39245,19332,19913,38964,281,257,5295.12,7.4
"2011","WN1","WN1","Total",20039,10110,9929,19834,205,207,1249.3,16
"2011","WN2","WN2","Total",52772,26292,26480,52212,560,345,4001.85,13.2
"2011","WN3","WN3","Total",29926,14913,15013,29846,80,201,1509.37,19.8
"2011","WN4","WN4","Total",28762,14313,14449,28598,164,268,1992.39,14.4
"2011","WN5","WN5","Total",43781,21684,22097,43412,369,314,2421.18,18.1
"2011","WN6","WN6","Total",39852,19673,20179,39662,190,461,3390.29,11.8
"2011","WN7","WN7","Total",47382,23433,23949,47036,346,392,1747.84,27.1
"2011","WN8","WN8","Total",45969,22373,23596,45566,403,416,4731.18,9.7
"2011","WR1","WR1","Total",8955,4608,4347,8607,348,113,248.79,36
"2011","WR10","WR10","Total",17726,8649,9077,17499,227,283,11298.42,1.6
"2011","WR11","WR11","Total",41614,20648,20966,40902,712,570,15572.48,2.7
"2011","WR12","WR12","Total",5436,2568,2868,5371,65,103,5990.21,0.9
"2011","WR13","WR13","Total",8195,3973,4222,7966,229,226,10328.74,0.8
"2011","WR14","WR14","Total",34207,16533,17674,32880,1327,546,3302.9,10.4
"2011","WR15","WR15","Total",7098,3503,3595,6962,136,120,10371.61,0.7
"2011","WR2","WR2","Total",29899,14610,15289,28791,1108,443,5959.99,5
"2011","WR3","WR3","Total",20472,10058,10414,20293,179,287,2116.86,9.7
"2011","WR4","WR4","Total",26036,12775,13261,25983,53,196,831.6,31.3
"2011","WR5","WR5","Total",31154,15208,15946,30758,396,396,3295.71,9.5
"2011","WR6","WR6","Total",12091,6041,6050,11966,125,288,24634.71,0.5
"2011","WR7","WR7","Total",4984,2466,2518,4946,38,118,6335.28,0.8
"2011","WR8","WR8","Total",8519,4108,4411,8269,250,178,11414.87,0.7
"2011","WR9","WR9","Total",31028,15069,15959,30708,320,447,13170.81,2.4
"2011","WS1","WS1","Total",27271,13752,13519,26704,567,242,577.62,47.2
"2011","WS10","WS10","Total",46711,22891,23820,46365,346,232,1272.08,36.7
"2011","WS11","WS11","Total",42593,20853,21740,42332,261,297,3402.65,12.5
"2011","WS12","WS12","Total",35408,17711,17697,35170,238,277,3139.63,11.3
"2011","WS13","WS13","Total",26628,13027,13601,26299,329,344,5825,4.6
"2011","WS14","WS14","Total",17105,8748,8357,16311,794,382,5215.93,3.3
"2011","WS15","WS15","Total",36552,17970,18582,36127,425,367,14039.39,2.6
"2011","WS2","WS2","Total",38754,18991,19763,38529,225,189,1089.88,35.6
"2011","WS3","WS3","Total",50097,24517,25580,49738,359,302,1528.27,32.8
"2011","WS4","WS4","Total",16805,8238,8567,16692,113,173,797.41,21.1
"2011","WS5","WS5","Total",21467,10380,11087,21401,66,250,747.98,28.7
"2011","WS6","WS6","Total",18183,8931,9252,17902,281,166,1226.6,14.8
"2011","WS7","WS7","Total",29867,14851,15016,29586,281,276,2589.65,11.5
"2011","WS8","WS8","Total",15586,7691,7895,15439,147,73,802.46,19.4
"2011","WS9","WS9","Total",26660,12999,13661,26521,139,325,3529.48,7.6
"2011","WV1","WV1","Total",16539,8671,7868,14957,1582,147,489.15,33.8
"2011","WV10","WV10","Total",56394,27775,28619,55347,1047,367,4005.7,14.1
"2011","WV11","WV11","Total",34571,17074,17497,34335,236,219,1919.03,18
"2011","WV12","WV12","Total",25649,12600,13049,25595,54,156,641,40
"2011","WV13","WV13","Total",20638,10115,10523,20544,94,103,573.17,36
"2011","WV14","WV14","Total",47169,23149,24020,46884,285,234,1370.81,34.4
"2011","WV15","WV15","Total",7939,3941,3998,7754,185,132,7366.64,1.1
"2011","WV16","WV16","Total",17290,8489,8801,17090,200,276,18736.7,0.9
"2011","WV2","WV2","Total",14720,7418,7302,14352,368,109,373.68,39.4
"2011","WV3","WV3","Total",28971,14432,14539,28442,529,333,782.28,37
"2011","WV4","WV4","Total",35122,17234,17888,34723,399,394,1876.68,18.7
"2011","WV5","WV5","Total",15883,7783,8100,15823,60,222,5522.79,2.9
"2011","WV6","WV6","Total",44995,22315,22680,44507,488,619,6146.4,7.3
"2011","WV7","WV7","Total",7166,3792,3374,6408,758,109,3659.64,2
"2011","WV8","WV8","Total",15580,7440,8140,15407,173,205,1506.69,10.3
"2011","WV9","WV9","Total",7231,3570,3661,7202,29,87,1442.25,5
"2011","YO1","YO1","Total",4514,2292,2222,4070,444,34,123.88,36.4
"2011","YO10","YO10","Total",30493,15068,15425,26003,4490,338,2046.35,14.9
"2011","YO11","YO11","Total",22899,11198,11701,21875,1024,194,4748.67,4.8
"2011","YO12","YO12","Total",40844,19674,21170,40156,688,501,6674.31,6.1
"2011","YO13","YO13","Total",10111,4825,5286,10030,81,211,22644.68,0.4
"2011","YO14","YO14","Total",11256,5350,5906,11251,5,113,6057.5,1.9
"2011","YO15","YO15","Total",13739,6777,6962,13067,672,134,3652.46,3.8
"2011","YO16","YO16","Total",25475,12134,13341,25189,286,193,5775.5,4.4
"2011","YO17","YO17","Total",21214,10459,10755,20962,252,282,41932.25,0.5
"2011","YO18","YO18","Total",10760,5096,5664,10615,145,166,26788.76,0.4
"2011","YO19","YO19","Total",12914,6157,6757,12533,381,247,12331.36,1
"2011","YO21","YO21","Total",14132,6841,7291,13813,319,211,28849.08,0.5
"2011","YO22","YO22","Total",8728,4279,4449,8486,242,120,15390,0.6
"2011","YO23","YO23","Total",19324,9361,9963,18971,353,355,7896.26,2.4
"2011","YO24","YO24","Total",29656,14352,15304,29277,379,341,826.22,35.9
"2011","YO25","YO25","Total",33310,16230,17080,32999,311,498,64807.13,0.5
"2011","YO26","YO26","Total",30202,14771,15431,29406,796,463,12668.14,2.4
"2011","YO30","YO30","Total",26611,13132,13479,25925,686,372,5333.01,5
"2011","YO31","YO31","Total",30239,14729,15510,29425,814,342,904.59,33.4
"2011","YO32","YO32","Total",28270,13359,14911,27820,450,483,6010.83,4.7
"2011","YO41","YO41","Total",10837,5572,5265,10139,698,193,13531.99,0.8
"2011","YO42","YO42","Total",14559,7114,7445,14354,205,288,25803.93,0.6
"2011","YO43","YO43","Total",12288,5995,6293,12191,97,151,16813.87,0.7
"2011","YO51","YO51","Total",5533,2688,2845,5435,98,94,4480.5,1.2
"2011","YO60","YO60","Total",4741,2328,2413,4733,8,127,15632.92,0.3
"2011","YO61","YO61","Total",14004,6751,7253,13847,157,365,31284.02,0.4
"2011","YO62","YO62","Total",12060,6061,5999,11358,702,270,51584.91,0.2
"2011","YO7","YO7","Total",19997,10017,9980,19357,640,336,30822.52,0.6
"2011","YO8","YO8","Total",43729,21532,22197,43386,343,514,25469.64,1.7
"2011","CF10","CF10","Total",14616,7990,6626,13464,1152,83,713.09,20.5
"2011","CF11","CF11","Total",36058,18603,17455,35429,629,222,854.11,42.2
"2011","CF14","CF14","Total",77856,37320,40536,74471,3385,1217,3004.12,25.9
"2011","CF15","CF15","Total",17823,8669,9154,17688,135,416,2992.53,6
"2011","CF23","CF23","Total",47027,22558,24469,45360,1667,757,1560.62,30.1
"2011","CF24","CF24","Total",55860,28777,27083,52317,3543,411,895.42,62.4
"2011","CF3","CF3","Total",42223,19958,22265,41936,287,307,4499.47,9.4
"2011","CF31","CF31","Total",44883,21961,22922,44519,364,634,1926.29,23.3
"2011","CF32","CF32","Total",29905,14689,15216,29856,49,271,12774.66,2.3
"2011","CF33","CF33","Total",14464,7077,7387,14383,81,114,1984.47,7.3
"2011","CF34","CF34","Total",20612,10125,10487,20609,3,150,4071.9,5.1
"2011","CF35","CF35","Total",16152,8727,7425,14656,1496,172,6996.72,2.3
"2011","CF36","CF36","Total",16005,7630,8375,15662,343,258,1338.79,12
"2011","CF37","CF37","Total",38323,18971,19352,37347,976,342,5692.97,6.7
"2011","CF38","CF38","Total",23277,11364,11913,23200,77,224,2200.9,10.6
"2011","CF39","CF39","Total",28926,14132,14794,28649,277,201,4201.34,6.9
"2011","CF40","CF40","Total",20588,10125,10463,20435,153,117,2177.99,9.5
"2011","CF41","CF41","Total",10755,5242,5513,10601,154,67,1278.16,8.4
"2011","CF42","CF42","Total",13421,6553,6868,13260,161,107,3483.94,3.9
"2011","CF43","CF43","Total",11884,5819,6065,11836,48,45,2031.62,5.8
"2011","CF44","CF44","Total",39211,19064,20147,38850,361,318,21496.56,1.8
"2011","CF45","CF45","Total",19553,9465,10088,19412,141,124,2329.97,8.4
"2011","CF46","CF46","Total",14280,7009,7271,14171,109,142,3427.83,4.2
"2011","CF47","CF47","Total",21886,10708,11178,21738,148,168,1170.59,18.7
"2011","CF48","CF48","Total",27283,13337,13946,27017,266,212,7639.5,3.6
"2011","CF5","CF5","Total",66024,31559,34465,65139,885,706,7601.65,8.7
"2011","CF61","CF61","Total",9983,4800,5183,9643,340,154,3293.12,3
"2011","CF62","CF62","Total",41446,20350,21096,40350,1096,487,6813.75,6.1
"2011","CF63","CF63","Total",21924,10695,11229,21872,52,136,647.87,33.8
"2011","CF64","CF64","Total",36574,17636,18938,36075,499,609,3576.29,10.2
"2011","CF71","CF71","Total",9049,4457,4592,8986,63,281,10029.36,0.9
"2011","CF72","CF72","Total",25557,12454,13103,25458,99,309,4907.09,5.2
"2011","CF81","CF81","Total",16431,8115,8316,16316,115,95,2924.5,5.6
"2011","CF82","CF82","Total",20233,9897,10336,20131,102,166,2756.7,7.3
"2011","CF83","CF83","Total",55242,27035,28207,55045,197,509,6601.41,8.4
"2011","LD1","LD1","Total",11341,5607,5734,11210,131,194,54433.88,0.2
"2011","LD2","LD2","Total",5688,2796,2892,5635,53,94,31255.45,0.2
"2011","LD3","LD3","Total",19241,9385,9856,18677,564,389,85165.67,0.2
"2011","LD4","LD4","Total",769,377,392,766,3,7,7700.76,0.1
"2011","LD5","LD5","Total",1106,572,534,1079,27,23,16195.32,0.1
"2011","LD6","LD6","Total",2681,1297,1384,2594,87,39,21084.2,0.1
"2011","LD7","LD7","Total",4812,2404,2408,4763,49,70,22438.6,0.2
"2011","LD8","LD8","Total",4154,2046,2108,4113,41,66,14299.56,0.3
"2011","LL11","LL11","Total",38337,19063,19274,37534,803,340,10282.36,3.7
"2011","LL12","LL12","Total",28326,13823,14503,28035,291,381,6162.76,4.6
"2011","LL13","LL13","Total",34865,17637,17228,34516,349,392,13547.07,2.6
"2011","LL14","LL14","Total",33424,16502,16922,33178,246,281,8839.47,3.8
"2011","LL15","LL15","Total",10832,5340,5492,10619,213,235,18812.15,0.6
"2011","LL16","LL16","Total",15848,7940,7908,15440,408,273,28202.75,0.6
"2011","LL17","LL17","Total",5276,2567,2709,5110,166,91,4830.12,1.1
"2011","LL18","LL18","Total",40552,19813,20739,40386,166,387,6863.36,5.9
"2011","LL19","LL19","Total",19924,9558,10366,19839,85,186,1911.15,10.4
"2011","LL20","LL20","Total",8317,4163,4154,8146,171,79,17892.32,0.5
"2011","LL21","LL21","Total",6066,3064,3002,6010,56,98,35251,0.2
"2011","LL22","LL22","Total",17700,8499,9201,17452,248,214,18881.77,0.9
"2011","LL23","LL23","Total",4362,2174,2188,4322,40,67,39263.53,0.1
"2011","LL24","LL24","Total",1939,1002,937,1876,63,33,27263.18,0.1
"2011","LL25","LL25","Total",474,240,234,474,0,4,5922.21,0.1
"2011","LL26","LL26","Total",4577,2219,2358,4512,65,50,7961.6,0.6
"2011","LL27","LL27","Total",783,392,391,782,1,13,3689.58,0.2
"2011","LL28","LL28","Total",14157,6618,7539,13694,463,219,6005.72,2.4
"2011","LL29","LL29","Total",20327,10056,10271,19789,538,319,1459.72,13.9
"2011","LL30","LL30","Total",21886,10380,11506,21051,835,251,1591.19,13.8
"2011","LL31","LL31","Total",9473,4640,4833,9261,212,122,1144.7,8.3
"2011","LL32","LL32","Total",6518,3166,3352,6488,30,99,9667.69,0.7
"2011","LL33","LL33","Total",3877,1920,1957,3753,124,38,4762.27,0.8
"2011","LL34","LL34","Total",4353,2097,2256,4310,43,43,1526.81,2.9
"2011","LL35","LL35","Total",878,447,431,871,7,12,1128.22,0.8
"2011","LL36","LL36","Total",4675,2218,2457,4562,113,73,16945.39,0.3
"2011","LL37","LL37","Total",526,268,258,526,0,12,1206.94,0.4
"2011","LL38","LL38","Total",721,357,364,717,4,8,288.11,2.5
"2011","LL39","LL39","Total",310,170,140,292,18,12,3488.2,0.1
"2011","LL40","LL40","Total",4132,2041,2091,4014,118,73,23095.31,0.2
"2011","LL41","LL41","Total",6479,3192,3287,6442,37,70,21570.32,0.3
"2011","LL42","LL42","Total",2522,1237,1285,2470,52,26,1600.34,1.6
"2011","LL43","LL43","Total",467,219,248,458,9,3,372.52,1.3
"2011","LL44","LL44","Total",1073,523,550,1057,16,13,4182.85,0.3
"2011","LL45","LL45","Total",645,316,329,632,13,12,5024.45,0.1
"2011","LL46","LL46","Total",1900,938,962,1829,71,15,3259.39,0.6
"2011","LL47","LL47","Total",550,278,272,547,3,9,4396.12,0.1
"2011","LL48","LL48","Total",2587,1277,1310,2564,23,44,4132.79,0.6
"2011","LL49","LL49","Total",4651,2283,2368,4547,104,71,5290.03,0.9
"2011","LL51","LL51","Total",630,329,301,630,0,2,5490.71,0.1
"2011","LL52","LL52","Total",2652,1253,1399,2583,69,42,2576.57,1
"2011","LL53","LL53","Total",17223,8521,8702,17142,81,278,32820.82,0.5
"2011","LL54","LL54","Total",11242,5513,5729,11195,47,176,20621.36,0.5
"2011","LL55","LL55","Total",21693,10601,11092,21439,254,298,21113.42,1
"2011","LL56","LL56","Total",2284,1145,1139,2212,72,33,589.92,3.9
"2011","LL57","LL57","Total",27683,13622,14061,24944,2739,391,11406.22,2.4
"2011","LL58","LL58","Total",3858,1859,1999,3819,39,68,3402.39,1.1
"2011","LL59","LL59","Total",5630,2733,2897,5591,39,99,2662.79,2.1
"2011","LL60","LL60","Total",3149,1573,1576,3149,0,48,5429.1,0.6
"2011","LL61","LL61","Total",6051,2917,3134,5870,181,92,5116.42,1.2
"2011","LL62","LL62","Total",1704,823,881,1666,38,27,4088.48,0.4
"2011","LL63","LL63","Total",1370,682,688,1370,0,18,3923.64,0.3
"2011","LL64","LL64","Total",1008,489,519,992,16,16,241.82,4.2
"2011","LL65","LL65","Total",23674,11783,11891,23349,325,180,20229.6,1.2
"2011","LL67","LL67","Total",1357,672,685,1357,0,7,1372.64,1
"2011","LL68","LL68","Total",6385,3166,3219,6327,58,70,7206.66,0.9
"2011","LL69","LL69","Total",595,303,292,595,0,9,116.2,5.1
"2011","LL70","LL70","Total",354,172,182,354,0,4,1323.71,0.3
"2011","LL71","LL71","Total",1726,881,845,1722,4,16,4307.85,0.4
"2011","LL72","LL72","Total",710,334,376,710,0,10,66.74,10.6
"2011","LL73","LL73","Total",254,127,127,254,0,9,1140.81,0.2
"2011","LL74","LL74","Total",2236,1062,1174,2229,7,26,333.8,6.7
"2011","LL75","LL75","Total",1491,713,778,1429,62,22,1833.64,0.8
"2011","LL76","LL76","Total",324,173,151,316,8,6,476.33,0.7
"2011","LL77","LL77","Total",7366,3558,3808,7333,33,102,7517.65,1
"2011","LL78","LL78","Total",509,254,255,509,0,19,333.84,1.5
"2011","NP10","NP10","Total",23201,11346,11855,23143,58,337,4770.9,4.9
"2011","NP11","NP11","Total",37796,18613,19183,37529,267,292,6543.33,5.8
"2011","NP12","NP12","Total",33524,16434,17090,33293,231,237,3399.85,9.9
"2011","NP13","NP13","Total",19827,9848,9979,19710,117,124,3609.94,5.5
"2011","NP15","NP15","Total",7866,4088,3778,7381,485,176,13871.15,0.6
"2011","NP16","NP16","Total",23955,11765,12190,23516,439,463,16425.81,1.5
"2011","NP18","NP18","Total",17277,8430,8847,16454,823,356,8420.93,2.1
"2011","NP19","NP19","Total",51623,25373,26250,51422,201,350,1276.37,40.4
"2011","NP20","NP20","Total",50789,24880,25909,50247,542,443,2242.55,22.6
"2011","NP22","NP22","Total",22024,10674,11350,21884,140,172,5082.74,4.3
"2011","NP23","NP23","Total",33505,16458,17047,33164,341,273,4299.57,7.8
"2011","NP24","NP24","Total",4966,2469,2497,4905,61,23,964.09,5.2
"2011","NP25","NP25","Total",15164,7398,7766,14622,542,362,16042.45,0.9
"2011","NP26","NP26","Total",22521,11164,11357,22421,100,329,7638.98,2.9
"2011","NP4","NP4","Total",45537,22307,23230,45148,389,350,13529.79,3.4
"2011","NP44","NP44","Total",47175,22873,24302,46825,350,453,4155.48,11.4
"2011","NP7","NP7","Total",26071,12592,13479,25756,315,409,32255.36,0.8
"2011","NP8","NP8","Total",5547,2719,2828,5481,66,131,19741.69,0.3
"2011","SA1","SA1","Total",47081,24501,22580,46428,653,309,2537.6,18.6
"2011","SA10","SA10","Total",29827,14545,15282,29530,297,284,8558.11,3.5
"2011","SA11","SA11","Total",36588,17945,18643,36243,345,295,9725.41,3.8
"2011","SA12","SA12","Total",32658,15825,16833,32447,211,242,4469.74,7.3
"2011","SA13","SA13","Total",19663,9750,9913,19571,92,164,12765,1.5
"2011","SA14","SA14","Total",33963,16563,17400,33594,369,345,11872.69,2.9
"2011","SA15","SA15","Total",36736,17970,18766,36341,395,344,7062.03,5.2
"2011","SA16","SA16","Total",8547,4164,4383,8508,39,63,4145.8,2.1
"2011","SA17","SA17","Total",9407,4595,4812,9335,72,82,11398.81,0.8
"2011","SA18","SA18","Total",29687,14578,15109,29319,368,341,13962.56,2.1
"2011","SA19","SA19","Total",9394,4646,4748,9284,110,169,48174.18,0.2
"2011","SA2","SA2","Total",38386,19070,19316,35688,2698,637,1987.95,19.3
"2011","SA20","SA20","Total",3574,1765,1809,3373,201,80,24469.01,0.1
"2011","SA3","SA3","Total",26235,12576,13659,25851,384,468,14387.36,1.8
"2011","SA31","SA31","Total",16923,7997,8926,16260,663,240,3428.81,4.9
"2011","SA32","SA32","Total",7758,3835,3923,7718,40,160,31304.76,0.2
"2011","SA33","SA33","Total",12346,6110,6236,12212,134,217,37611.01,0.3
"2011","SA34","SA34","Total",5398,2685,2713,5378,20,73,19910.43,0.3
"2011","SA35","SA35","Total",715,364,351,713,2,6,4247.69,0.2
"2011","SA36","SA36","Total",395,210,185,395,0,6,676.22,0.6
"2011","SA37","SA37","Total",1287,649,638,1284,3,18,4159.06,0.3
"2011","SA38","SA38","Total",4761,2310,2451,4681,80,51,10630.41,0.4
"2011","SA39","SA39","Total",2321,1168,1153,2298,23,26,6014.38,0.4
"2011","SA4","SA4","Total",44356,21613,22743,44107,249,517,9352.91,4.7
"2011","SA40","SA40","Total",3580,1748,1832,3482,98,31,10924.54,0.3
"2011","SA41","SA41","Total",1882,971,911,1882,0,39,9091.25,0.2
"2011","SA42","SA42","Total",2306,1100,1206,2290,16,40,5623.72,0.4
"2011","SA43","SA43","Total",12535,6100,6435,12448,87,171,15315.95,0.8
"2011","SA44","SA44","Total",11490,5634,5856,11386,104,178,27441.54,0.4
"2011","SA45","SA45","Total",1730,861,869,1716,14,25,1544.36,1.1
"2011","SA46","SA46","Total",2732,1305,1427,2703,29,47,2709.58,1
"2011","SA47","SA47","Total",1250,648,602,1249,1,16,3294.15,0.4
"2011","SA48","SA48","Total",8951,4496,4455,8417,534,156,23326.59,0.4
"2011","SA5","SA5","Total",36460,17628,18832,36176,284,262,3743.05,9.7
"2011","SA6","SA6","Total",34182,16705,17477,33939,243,286,4888.15,7
"2011","SA61","SA61","Total",14262,6832,7430,14149,113,168,1431.09,10
"2011","SA62","SA62","Total",21332,10564,10768,20591,741,380,57062.69,0.4
"2011","SA63","SA63","Total",1112,556,556,1112,0,20,4774.13,0.2
"2011","SA64","SA64","Total",2462,1229,1233,2451,11,34,3960.72,0.6
"2011","SA65","SA65","Total",4379,2095,2284,4298,81,54,6117.35,0.7
"2011","SA66","SA66","Total",3021,1469,1552,3016,5,66,10475.7,0.3
"2011","SA67","SA67","Total",6930,3339,3591,6777,153,111,13488.2,0.5
"2011","SA68","SA68","Total",4305,2114,2191,4252,53,66,6116.49,0.7
"2011","SA69","SA69","Total",3534,1755,1779,3447,87,59,915.63,3.9
"2011","SA7","SA7","Total",15118,7370,7748,14961,157,118,1617.98,9.3
"2011","SA70","SA70","Total",9731,4689,5042,9453,278,141,7065.05,1.4
"2011","SA71","SA71","Total",10272,5003,5269,10139,133,151,11877.74,0.9
"2011","SA72","SA72","Total",10581,5250,5331,10500,81,95,1936.96,5.5
"2011","SA73","SA73","Total",20354,9910,10444,20261,93,225,5268.24,3.9
"2011","SA8","SA8","Total",12556,6160,6396,12409,147,135,5236.48,2.4
"2011","SA9","SA9","Total",15179,7422,7757,14976,203,136,11470.78,1.3
